Aa, Aa, Aa, Aa, Aa, Aa, Aa, Aa, Aa, Aa, Hh, Hh, Hh, Ha, Ha, Ha, Ha^Fma, Aa^Fpa, Ha^Fma, Aa^Fpa, Hh^Fdw, Ha^Fpa, Ha^Fpa, Ha^Fpa, Mm, Ms, Ms, Ms, Ms, Ms, Ms, Ms
Aa, Aa, Aa, Aa, Gg^Efm, Aa, Aa, Aa, Aa, Gg, Gg^Efm, Hh, Aa, Ha, Ha, Ha, Hh^Fdw, Hh^Fdw, Ha^Fma, Ha^Fma, Ha^Fma, Ha^Fda, Ha^Fpa, Ha^Fpa, Ha^Fpa, Mm, Mm, Ms, Mm, Mm, Mm, Ms
Aa, Aa, Gg^Efm, Gg^Efm, Gg, Gg^Efm, Aa, Gg^Vo, Gg, Gg, Gg^Efm, Gg^Efm, Aa, Aa, Aa, Ha, Aa^Fpa, Hh^Fdw, Aa^Fpa, Ha^Fma, Aa^Fpa, Ha^Fpa, Hh^Fdw, Ha^Vca, Ha^Fpa, Ha^Fda, Ha^Fma, Mm, Mm, Mm, Ms, Ms
Aa, Aa, Aa, Gg^Efm, Gg^Efm, Gg^Efm, Aa, Aa, Aa, Aa, Aa, Gg^Efm, Aa, Aa, Aa, Aa, Aa^Fpa, Aa^Fpa, Aa^Fpa, Aa^Fpa, Aa^Fpa, Aa^Fpa, Aa^Fpa, Ha^Fpa, Ha^Fda, Hh^Fdw, Ha^Fpa, Hh^Fdw, Ha^Fpa, Mm, Mm, Ms
Aa, Aa, Aa, Gg^Vo, Aa, Aa, Cea, Aa, Cea, Aa, Gg^Vo, Aa, Aa, Aa, Aa, Aa, Aa^Fpa, Gs^Fms, Aa^Fpa, Aa^Fpa, Aa^Fpa, Aa^Fpa, Aa^Fpa, Aa^Fpa, Aa^Fpa, Ha^Fpa, Ha^Fma, Ha^Fda, Hh^Fdw, Ha^Fpa, Ha^Fpa, Mm
Aa, Aa, Aa, Aa, Aa, Aa, Cea, 1 Kea, Cea, Gg^Efm, Gg^Efm, Gg^Efm, Gg^Efm, Aa, Aa, Aa, Aa^Fpa, Aa^Fpa, Aa^Fpa, Aa^Fpa, Aa^Fpa, Aa^Fpa, Aa^Fpa, Aa^Fpa, Aa^Fpa, Aa^Fpa, Aa^Fpa, Ha^Fpa, Ha^Fpa, Ha^Vca, Ha^Fpa, Ha^Fpa
Aa, Aa, Aa, Gg^Efm, Gg^Vo, Aa, Aa, Aa, Aa, Gg^Efm, Gg^Efm, Gg, Gg^Efm, Aa, Aa, Aa, Aa^Fpa, Aa^Fpa, Aa^Fpa, Aa^Fpa, Aa^Fda, Aa^Fpa, Aa^Fpa, Gs^Fmw, Aa^Fpa, Aa^Fpa, Aa^Fpa, Aa^Fpa, Aa^Fpa, Ha^Fpa, Hh^Fdw, Ha^Fpa
Aa, Aa, Aa, Gg, Gg^Efm, Gg^Efm, Gg^Vo, Aa, Aa, Gg^Efm, Gg^Vo, Gg^Efm, Aa, Aa, Aa, Aa, Aa^Fpa, Aa^Fpa, Aa^Fpa, Aa^Fpa, Aa^Fpa, Aa^Fpa, Aa^Fpa, Aa^Fpa, Aa^Fma, Aa^Fda, Aa^Fpa, Aa^Fpa, Aa^Fpa, Aa^Fpa, Aa^Fpa, Hh^Fdw
Aa, Aa, Aa, Gg^Efm, Aa, Gg^Efm, Gg, Gg^Efm, Aa, Aa, Aa, Aa, Aa, Aa, Aa, Aa, Aa^Fpa, Aa^Fpa, Aa^Fpa, Aa^Fpa, Aa^Fpa, Aa^Fpa, Aa^Fpa, Aa^Fpa, Aa^Fpa, Aa^Fpa, Aa^Fpa, Aa^Fpa, Gs^Fms, Aa^Fpa, Aa^Fpa, Aa^Fpa
Aa, Aa, Aa, Aa, Aa, Aa, Aa, Aa, Aa, Aa, Aa, Aa, Aa, Aa, Aa, Aa, Aa^Fpa, Aa^Fpa, Gs^Fp, Aa^Fpa, Aa^Fpa, Aa^Fpa, Aa^Fpa, Aa^Fpa, Aa^Fpa, Aa^Fpa, Aa^Fpa, Aa^Fda, Aa^Fpa, Aa^Fpa, Aa^Fma, Aa^Fpa
Aa, Aa, Aa, Aa, Aa, Aa, Aa, Aa, Aa, Aa, Aa, Aa, Aa, Aa, Aa, Aa^Fpa, Aa^Fpa, Aa^Fpa, Aa^Fpa, Aa^Fpa, Aa^Fda, Aa^Fpa, Aa^Fpa, Aa^Fpa, Aa^Fpa, Aa^Fpa, Aa^Fpa, Aa^Fma, Aa^Fpa, Aa^Fpa, Aa^Fpa, Aa^Fpa
Aa, Aa, Aa, Aa, Aa, Aa, Aa, Aa, Aa, Aa, Aa, Aa, Aa, Aa, Aa, Aa^Fpa, Aa^Fpa, Aa^Fpa, Aa^Fpa, Aa^Fpa, Aa^Fpa, Aa^Fpa, Aa^Fpa, Aa^Fpa, Gs^Fdf, Gs^Fdf, Gs^Fmf, Aa^Fpa, Aa^Fpa, Aa^Fpa, Aa^Fpa, Aa^Fpa
Aa, Aa, Aa, Aa, Aa, Aa, Aa, Aa, Aa, Aa, Aa, Aa, Aa^Fpa, Aa, Aa^Fpa, Aa^Fpa, Aa^Fpa, Aa^Fda, Aa^Fpa, Aa^Fpa, Aa^Fpa, Aa^Fda, Gs^Fmw, Gs^Fdf, Gs^Fmf, Gs^Fmw, Gs^Fdf, Gs^Fmw, Gs^Fmw, Aa^Fpa, Aa^Fpa, Aa^Fpa
Aa^Fpa, Aa^Fpa, Aa^Fpa, Aa^Fpa, Aa^Fpa, Aa, Aa^Fpa, Aa^Fpa, Aa^Fpa, Aa^Fpa, Aa, Aa^Fpa, Aa^Fpa, Aa^Fpa, Aa^Fpa, Aa^Fpa, Aa^Fpa, Aa^Fpa, Aa^Fpa, Aa^Fpa, Aa^Fda, Gs^Fmw, Aa^Fpa, Gs^Fmw, Aa^Fpa, Gs^Fmf, Aa^Fpa, Gs^Fmw, Aa^Fpa, Gs^Fmw, Aa^Fpa, Aa^Fpa
Aa^Fpa, Aa^Fpa, Aa^Fda, Aa^Fpa, Aa^Fpa, Aa^Fpa, Aa^Fpa, Aa^Fpa, Aa^Fpa, Aa^Fpa, Aa^Fda, Aa, Aa, Aa^Fpa, Aa^Fpa, Aa^Fpa, Aa^Fpa, Aa^Fda, Aa^Fda, Aa^Fpa, Aa^Fpa, Aa^Fpa, Aa^Fpa, Aa^Fpa, Aa^Fpa, Gs^Fdf, Aa^Fpa, Aa^Fpa, Aa^Fpa, Aa^Fpa, Aa^Fpa, Aa^Fpa
Aa^Fpa, Aa^Fpa, Aa^Fpa, Aa^Fpa, Aa^Fpa, Aa^Fpa, Aa^Fpa, Aa^Fpa, Aa^Fpa, Aa^Fpa, Gs^Fds, Gs^Fp, Gs^Fds, Aa, Aa^Fda, Aa^Fpa, Aa^Fda, Aa^Fda, Aa^Fpa, Aa^Fda, Aa^Fpa, Aa^Fpa, Aa^Fpa, Aa^Fpa, Aa^Fpa, Aa^Fpa, Aa^Fpa, Aa^Fpa, Aa^Fpa, Aa^Fpa, Ai, Ai
Aa^Fpa, Aa^Fpa, Aa^Fpa, Aa^Fpa, Aa^Fpa, Aa^Fpa, Aa^Fpa, Aa^Fda, Aa^Fpa, Gs^Fp, Re, Re, Gg^Fet, Gg, Gs^Fp, Aa^Fpa, Aa^Fpa, Aa^Fpa, Aa^Fpa, Aa^Fpa, Aa^Fpa, Aa^Fpa, Aa^Fpa, Aa^Fma, Aa^Fpa, Aa^Fpa, Aa^Fpa, Aa^Fpa, Ww, Ww, Ww, Ww
Aa^Fpa, Aa^Fpa, Aa^Fpa, Aa^Fpa, Aa^Fpa, Aa^Fpa, Aa^Fpa, Aa^Fpa, Aa^Fpa, Gs^Fds, Re, Gg, Re, Re, Gs^Fp, Aa^Fpa, Aa^Fma, Aa^Fpa, Aa^Fpa, Aa^Fpa, Aa^Fpa, Aa^Fpa, Aa^Fpa, Aa^Fpa, Ai, Aa^Fpa, Ww, Ww, Ai, Ai, Aa^Vca, Aa^Fpa
Aa^Fpa, Aa^Fpa, Aa^Fpa, Aa^Fpa, Aa^Fpa, Aa^Fpa, Aa^Fpa, Aa^Fpa, Aa^Fpa, Aa^Fpa, Gs^Fmf, Re, Re, Gg, Aa^Fpa, Aa^Fpa, Aa^Fpa, Aa^Fpa, Ai, Ai, Ww, Aa^Fpa, Ww, Ww, Ww, Ww, Aa, Ai, Aa^Fpa, Aa, Gs^Fp, Aa^Fpa
Aa^Fpa, Aa^Fpa, Aa^Fpa, Aa^Fpa, Aa^Fma, Aa^Fpa, Aa^Fda, Aa^Fpa, Aa^Fpa, Aa^Fpa, Aa^Fpa, Aa^Fda, Aa, Gs^Fmf, Aa^Fpa, Ai, Ww, Ai, Ww, Ww, Ha^Kov, Ww, Ai, Ai, Aa^Fma, Aa^Fpa, Aa^Fpa, Aa^Fpa, Aa^Fpa, Gs^Fp, Gs^Fp, Aa^Fpa
Aa^Fpa, Aa^Fpa, Aa^Fpa, Aa^Fpa, Aa^Fpa, Aa^Fpa, Aa^Fpa, Aa^Fpa, Aa^Fpa, Aa^Fma, Aa^Fpa, Aa^Fpa, Rd, Aa^Fpa, Ww, Ww, Ai, Ww, Aa^Fpa, Ha^Kov, Aa^Fpa, Ai, Aa^Fpa, Aa^Vca, Aa^Fpa, Aa^Fpa, Aa^Fpa, Aa^Fda, Aa^Fpa, Aa^Fpa, Gs^Fp, Gs^Fp
Aa^Fpa, Aa^Fpa, Aa^Fpa, Aa^Fpa, Aa^Fpa, Aa^Fpa, Aa^Fpa, Aa^Fpa, Ai, Ai, Ww, Ai, Ww, Wwf^Bw\, Wwf^Bw\, Ai, Aa^Fpa, Aa^Fpa, Gs^Fp, Ha^Kov, Aa^Fpa, Aa^Fpa, Aa^Fpa, Aa^Fpa, Aa^Fpa, Aa^Fpa, Gs^Fp, Aa^Fpa, Aa^Fpa, Gs^Fp, Gs^Fp, Gs^Fp
Aa^Fpa, Aa^Fpa, Aa^Fpa, Aa^Fpa, Aa^Fpa, Aa^Fpa, Ai, Ai, Ww, Ww, Ai, Ww, Aa^Fpa, Aa^Fpa, Aa^Fpa, Rd, Aa, Aa, Gs^Fp, Gs^Fp, Gs^Fp, Gs^Fp, Aa^Fpa, Aa^Fpa, Gs^Fp, Gs^Fp, Aa^Fpa, Aa^Fpa, Aa^Fpa, Gs^Fp, 2 Gs^Fp, Aa^Fpa
Aa^Fpa, Aa^Fpa, Aa^Fpa, Aa^Fpa, Ai, Ai, Ww, Ww, Aa^Fpa, Aa^Fpa, Aa^Fpa, Aa^Fpa, Aa^Fpa, Aa^Fpa, Aa^Fpa, Aa^Fpa, Aa^Fpa, Gs^Fp, Aa, Aa^Fpa, Aa^Fpa, Aa^Fpa, Aa^Fpa, Aa^Fpa, Aa^Fpa, Aa^Fpa, Aa^Fpa, Aa^Fpa, Aa^Fpa, Aa^Fpa, Aa^Fpa, Aa^Fpa
