Aa, Aa, Aa, Aa, Aa, Aa, Aa, Gg, Gg, Gg, Aa^Fda, Aa^Fda, Aa^Fda, Gg, Aa^Fda, Aa^Fda, Aa, Ai, Ai, Ai, Ai, Aa, Aa, Aa^Fpa, Aa^Fpa, Aa^Fpa, Aa^Fpa, Aa^Fpa, Aa^Fpa, Ha^Fma, Ha^Fma, Ha^Fma, Ha^Fma, Mm, Mm, Mm, Mm, Mm, Ms, Ms, Ms, Aa, Aa, Gg, Gg, Gg, Gg, Gg, Gg, Gg, Gg, Gg, Gg, Gg, Gg, Gg, Gg, Gg, Aa, Gg, Gg, Gg
Aa, Aa, Aa, Aa, Aa, Aa, Aa, Aa, Aa, Gg, Aa^Fda, Aa^Fda, Aa^Fda, Aa^Fda, Aa^Fda, Aa^Fda, Aa, Aa, Aa, Ai, Ai, Ai, Ai, Aa, Aa, Aa^Fpa, Aa, Aa^Fpa, Aa, Ha^Fma, Ha^Fma, Ha^Fma, Ha^Fma, Ha^Fma, Ha^Fma, Mm^Vhh, Aa, Ms, Ms, Ms, Aa, Aa, Aa, Aa, Aa, Gg, Ce, Ce, Ce, Gg, Gg, Gg, Aa, Aa, Ce, Ce, Ce, Aa, Aa, Aa, Aa, Gg
Aa, Aa, Aa, Aa, Aa, Aa, Aa, Aa, Aa, Gg, Aa^Fda, Aa^Fda, Aa^Fda, Aa^Fda, Aa^Fda, Aa^Fda, Aa, Aa, Aa, Aa^Fda, Aa, Ai, Ai, Ai, Ai, Aa, Aa, Aa^Fda, Aa, Aa, Ha^Fda, Ha^Fpa, Ha, Ha^Fma, Gg, Gg, Gg, Aa, Aa, Aa^Vha, Aa, Aa, Aa, Aa, Aa, Aa, Cea, 4 Ke, Ce, Gll, Aa, Aa, Gg, Gg, Ce, Aa^Dr, Ce, Gg, Aa, Aa, Gll, Gg
Aa, Aa, Aa, Aa, Aa, Aa, Aa, Aa, Aa, Gg, Aa^Fda, Aa^Fda, Aa, Aa, Aa, Aa^Fda, Aa, Aa, Aa, Aa, Aa, Aa, Aa, Ai, Ai, Ai, Ai, Aa, Aa, Ha^Fma, Ai, Ai, Ai, Ha, Ha, Gg, Ce, Gg, Gg, Aa, Aa^Fda, Aa, Aa, Aa, Re, Aa, Re, Ce, Gll, Gll, Aa, Aa, Aa, Gg, Re, Cea, Re, Gg, Aa, Gll, Chr, Gll
Ha, Ha, Aa, Aa, Aa, Aa, Ai, Aa, Aa, Aa^Fda, Aa, Aa, Aa, Aa, Aa, Aa, Aa, Aa, Aa, Aa, Aa, Aa, Aa, Aa, Aa^Fda, Ai, Ai, Ai, Ai, Ai, Ai, Ai, Ai, Ai^Bw/, Ha, Cea, 2 Ke, Ce, Gs, Aa, Aa, Aa, Aa, Aa, Re, Re, Re, Re, Aa, Aa, Aa, Aa, Aa, Re, Aa, Aa, Aa, Aa, Chr, Chr, Chr^Dr, Chr
Ha, Ha, Ha, Aa, Ai, Ai, Aa, Aa, Ai, Aa, Ai, Aa, Ai, Aa, Ai, Aa, Ai, Aa, Ai, Aa, Aa, Aa, Aa, Aa, Aa, Aa, Aa, Ai, Ai, Ai, Ai, Wwr, Ai, Ai, Aa, Cea, Ce, Cea, Aa, Aa, Aa^Fda, Aa, Aa, Aa, Aa, Aa, Aa, Aa, Aa, Aa^Vha, Aa, Aa, Aa, Aa^Fda, Aa, Aa, Aa, Aa, Gs, Gs, 5 Khr, Chr
Ha, Ha^Vhha, Ha, Aa, Aa, Ai, Ai, Aa, Aa, Aa, Aa, Aa, Aa, Aa, Aa, Aa, Aa, Aa, Aa, Aa, Aa, Aa, Aa, Aa, Aa, Aa, Aa, Aa, Aa, Ai, Ai, Ai, Ai, Ai, Aa, Re, Re, Re, Aa, Aa, Aa^Fda, Aa, Aa, Aa, Aa^Fda, Aa, Aa^Dr, Aa, Aa, Aa, Aa, Aa, Aa, Aa, Aa, Aa, Aa, Aa, Chr^Dr, Gs, Chr, Chr
Aa, Ha, Aa, Aa, Aa, Aa, Aa, Aa, Aa, Aa, Aa, Aa, Aa, Aa, Aa, Aa, Aa, Aa, Aa, Aa, Aa, Aa, Aa, Aa, Aa, Aa, Gs, Aa, Gs, Aa, Aa, Ai, Aa, Aa, Aa, Aa, Aa, Aa, Aa, Aa^Fda, Aa^Fda, Aa, Aa, Aa, Aa, Aa, Aa, Aa, Aa, Aa, Aa^Fda, Aa, Aa, Aa, Aa, Aa^Fda, Aa, Aa, Aa, Chr, Chr, Chr^Dr
Aa, Aa, Aa, Aa, Aa, Aa, Aa, Aa, Aa, Aa, Gg, Aa, Gg^Vc, Gg, Aa, Aa, Aa, Aa, Aa, Aa, Aa, Aa, Aa, Aa, Aa, Aa^Dr, Aa, Gs, Aa, Aa, Gll, Aa, Aa, Aa^Dr, Aa, Aa, Re, Aa, Aa, Aa, Aa, Aa, Gg, Aa, Aa, Aa, Aa, Aa, Aa, Aa, Aa, Aa, Aa, Aa, Gs, Aa, Gs, Aa, Aa, Aa, Aa, Aa
Aa, Aa, Aa, Aa, Aa, Aa, Aa, Aa, Aa, Aa, Aa, Gll, Gg, Gg, Aa, Aa, Aa, Aa^Fda, Aa^Fda, Aa, Aa, Aa, Aa, Aa, Aa, Aa, Aa, Aa, Gg, Gll, Gs, Gll, Aa, Aa, Aa, Re, Re, Aa, Aa, Aa, Aa, Aa, Aa, Aa, Aa, Aa, Aa, Aa, Aa, Aa, Aa, Aa, Re, Re, Ce, Cea, Cea, Aa, Aa, Aa, Aa, Aa
Aa, Aa, Aa, Aa, Aa, Aa, Aa, Aa, Aa, Aa, Aa, Aa, Gg, Gg, Gg, Aa, Aa, Aa^Fma, Aa, Aa, Aa, Aa^Dr, Aa, Aa, Aa, Aa, Aa, Aa, Aa, Gg, Gs, Aa, Aa, Gll, Gll, Re, Aa, Aa, Aa, Aa, Aa, Aa, Aa, Aa, Aa^Dr, Aa, Aa, Aa, Aa, Aa, Aa, Aa, Aa, Re, Cea, Aa^Dr, Cea, Gs, Aa, Aa, Aa^Vha, Aa
Aa, Aa, Aa, Aa, Aa, Aa, Aa, Aa, Aa, Aa, Aa, Aa, Gg, Gg, Gg, Gg, Rd, Rd, Aa, Aa, Aa, Aa, Aa, Aa, Aa, Aa^Fda, Aa^Fda, Aa, Aa, Gg, Aa, Aa, Aa, Aa, Aa, Aa, Aa, Aa^Fda, Aa, Aa, Re, Aa, Aa, Aa, Aa, Aa, Aa, Aa, Aa, Aa^Fda, Aa, Aa, Aa^Dr, Gs, Aa, Cea, Aa, Gs, Aa^Fda, Aa, Aa, Aa
Aa, Aa, Aa, Aa, Aa, Aa, Aa, Aa, Aa, Aa, Aa, Aa, Gg, Ce, Aa, Rd, Aa, Aa, Aa, Aa, Aa, Aa, Aa, Aa, Aa, Aa^Fda, Aa, Aa, Aa, Aa, Aa, Aa, Aa, Aa, Aa, Aa^Fda, Aa^Fda, Aa^Fda, Aa, Re, Re, Re, Re, Aa, Re, Re, Aa, Aa, Aa, Aa, Aa, Aa, Gs, Aa, Re, Re, Re, Aa, Aa, Aa, Aa, Aa
Aa, Aa, Aa, Aa, Aa, Aa, Re^Vct, Aa, Aa, Aa, Gg, Gg, Rd, Aa, Aa, Aa, Aa, Aa, Aa, Aa^Vha, Gs, Aa, Aa, Aa, Gs, Aa, Aa, Aa^Dr, Aa, Aa, Aa, Aa, Aa, Aa, Aa, Aa^Fda, Aa, Aa, Aa, Gg, Gg, Re, Ce, Cea, Ce, Re, Aa, Aa, Aa, Aa, Aa, Aa, Aa, Gs, Aa, Re, Re, Re, Cea, Aa, Aa, Aa
Aa, Aa, Aa, Aa, Aa, Aa, Aa, Aa, Aa, Aa, Rd, Rd, Rd, Aa, Rd, Aa, Aa, Aa, Aa, Aa, Aa, Gs, Gg, Gs, Gs, Aa, Aa, Aa, Aa, Aa, Aa, Aa, Aa, Aa, Aa, Aa, Aa, Aa, Aa, Aa, Aa, Gg, Cea, 3 Ke, Ce, Gg, Aa, Aa, Aa, Aa^Fda, Aa, Gs, Aa, Aa, Gg, Gg, Gg, Cea, Aa^Dr, Cea, Aa, Aa
Aa, Aa, Re^Vct, Aa, Aa, Aa, Aa, Aa, Rd, Rd, Rd, Rd, Rd, Rd, Gs, Ce, Aa, Aa, Aa, Aa, Aa, Gg, Gg, Gg, Gg, Gg, Aa, Aa, Gg, Gg, Gg, Aa^Vea, Aa, Aa, Aa, Aa^Dr, Aa, Aa, Aa, Aa, Aa, Aa, Aa, Cea, Gg, Gg, Gg, Aa, Aa^Vca, Aa, Aa, Aa, Aa, Aa, Aa, Gs, Gg, Ha^Dr, Cea, Ha^Dr, Aa, Aa
Aa, Aa, Aa, Aa, Aa, Aa, Cea, Cea, Ce, Rd, Rd, Rd, Aa, Gs, Gg, Aa, Gg, Aa, Aa, Aa, Aa, Aa, Aa, Aa, Aa, Aa, Aa, Aa, Aa, Gg, Gg, Aa, Aa, Aa, Aa, Aa, Aa, Aa, Aa^Vha, Aa, Aa, Aa, Aa, Aa, Aa, Gg, Gg, Gg, Aa, Aa, Aa, Aa, Aa, Aa, Aa, Aa, Aa, Aa, Aa, Aa, Aa, Aa
Aa, Aa, Aa, Aa, Aa, Aa, Cea, 1 Kea, Cea, Rd, Aa, Aa, Aa, Aa, Aa, Gg, Aa, Aa, Aa, Aa, Aa, Aa, Aa, Aa^Dr, Aa, Aa, Aa, Aa, Aa, Gg, Gg, Aa, Aa, Aa, Aa, Aa, Aa, Aa, Aa, Aa, Aa, Aa, Aa, Aa, Aa, Gg, Gg, Gg, Aa, Aa, Aa, Aa, Aa, Re, Aa^Dr, Aa, Aa, Aa, Aa, Aa, Aa, Aa
Rd, Aa, Rd, Rd, Rd, Aa, Aa, Cea, Aa, Aa, Aa, Aa, Aa, Aa, Aa, Aa, Aa, Aa, Aa, Aa, Aa, Aa, Aa, Aa, Aa, Aa^Vea, Aa, Aa, Aa, Aa, Aa, Aa, Aa, Aa, Aa, Aa, Aa, Aa, Aa, Aa, Aa, Aa, Aa^Dr, Aa, Aa, Gg, Gg, Gg, Aa, Aa, Aa, Aa, Aa, Aa, Aa, Aa, Aa, Aa, Aa, Aa, Aa, Aa
Rd, Rd, Rd, Rd, Aa, Aa, Aa, Aa, Aa, Aa, Re^Vct, Aa, Aa, Aa, Aa, Aa, Aa, Aa, Aa, Aa, Gg, Aa, Aa, Aa, Aa, Aa, Aa, Aa, Aa, Aa, Aa, Aa, Aa, Aa, Aa, Gg, Aa, Aa, Aa, Aa, Aa, Aa, Aa, Aa, Aa, Aa, Aa, Aa, Aa, Aa, Re, Aa, Re, Aa, Aa, Aa, Aa^Vha, Aa, Aa, Aa, Aa, Aa
Rd, Rd, Rd, Rd, Aa, Re^Vct, Aa, Aa, Aa, Aa, Aa, Aa, Aa, Aa, Aa, Aa, Aa, Aa, Aa, Gg, Gg^Vc, Gg, Gg, Aa, Aa, Gg, Gg, Aa, Aa, Aa, Aa, Aa, Aa, Aa, Aa, Aa, Aa, Aa^Dr, Aa, Aa, Aa, Aa, Aa, Aa, Aa, Aa, Aa, Aa, Aa, Aa, Re, Re, Aa, Aa, Aa, Aa, Aa, Aa, Aa, Aa, Aa, Aa
Rd, Rd, Aa, Aa, Aa, Aa, Gg, Gg, Gg, Aa, Aa, Aa, Aa, Aa, Gg, Aa, Aa, Aa, Aa, Gg, Gg, Gg, Aa, Aa, Aa, Aa, Aa, Aa, Aa, Aa^Dr, Aa, Aa, Aa, Aa, Aa, Aa, Aa, Aa, Aa, Gg, Gg, Aa, Aa, Aa, Aa, Aa^Vha, Aa, Aa, Aa, Aa, Aa, Aa, Aa, Aa, Aa, Aa, Aa, Aa, Re, Aa, Aa, Aa
Gg, Aa, Aa, Aa, Aa, Aa, Gg^Vc, Aa, Aa, Aa, Aa, Aa, Aa, Aa, Gg^Vc, Gg, Cea, Cea, Cea, Aa, Aa, Gg, Aa, Aa, Aa, Aa, Aa, Gg, Gg, Aa, Aa, Aa, Aa, Gg, Aa, Aa, Aa, Aa, Aa, Gg, Aa, Gg, Aa, Aa, Aa, Aa, Aa, Aa, Aa, Aa, Aa, Aa, Aa, Aa, Re, Aa, Aa^Dr, Aa, Aa, Aa, Aa, Aa
Aa, Aa, Aa, Aa, Aa, Aa, Aa, Aa, Aa, Aa, Aa, Aa, Aa, Aa, Gg, Gg, Cea, 6 Kea, Cea, Aa, Aa, Gg, Aa, Aa, Aa, Aa, Aa, Gg, Gg, Aa, Aa, Aa, Aa, Aa, Aa, Aa, Aa, Aa, Aa, Aa, Aa, Aa, Aa, Aa, Aa, Aa, Aa, Aa, Aa, Re, Aa, Aa, Aa, Aa, Aa, Aa, Aa, Aa, Aa, Aa, Aa, Aa
Aa, Aa, Aa, Aa, Aa, Aa, Aa, Aa, Aa, Aa, Aa, Aa, Aa, Aa, Aa, Gg, Aa, Cea, Aa, Aa, Aa, Aa, Aa, Aa, Aa, Aa, Aa^Dr, Aa, Aa, Aa, Aa, Aa, Aa^Vea, Aa, Aa^Dr, Aa, Aa, Aa, Aa, Aa, Aa, Aa, Aa, Gg, Gg, Gg, Aa, Aa, Aa, Aa, Aa, Aa, Aa, Aa, Aa, Aa, Aa, Aa, Aa^Vha, Aa, Aa, Aa
Gg, Gg, Aa, Aa, Aa, Aa, Aa, Aa, Aa, Aa, Aa, Aa, Aa, Aa, Aa, Aa, Gg, Aa, Aa, Aa, Aa, Aa, Aa, Aa^Vea, Aa, Aa, Aa, Aa, Aa, Aa, Aa, Aa, Aa, Aa, Aa, Aa, Aa, Aa, Aa, Aa, Aa, Aa, Aa, Gg, Gg, Gg, Aa, Aa, Aa, Aa^Dr, Aa, Aa, Aa, Aa, Gg, Gg, Aa, Aa, Aa, Aa, Aa, Aa
Gg, Gg, Aa, Aa, Aa, Aa, Aa, Aa, Aa, Aa, Aa, Aa, Aa, Aa, Aa, Aa, Gg, Gg, Gg, Aa, Aa, Aa, Aa, Aa, Aa, Aa, Aa, Aa, Aa, Gg, Gg, Aa, Aa, Aa, Gg, Gg, Gg, Gg, Gg, Aa, Aa, Aa, Gg, Gg, Gg, Gg, Gg, Aa, Aa, Aa, Gg, Gg, Gg, Gg, Gg, Gg, Gg, Aa, Aa, Aa, Aa, Aa
