Gg, Gg, Gg, Gg, Aa, Aa, Aa, Aa, Aa, Rd, Rd, Gg, Gg, Gg, Aa, Aa, Aa, Aa, Aa, Aa, Aa, Aa, Aa, Aa, Aa, Aa, Aa, Gg, Gs, Gg, Gs, Gg
Gg, Gs, Gg, Aa, Aa, Aa, Aa, Aa, Aa, Rd, Rd, Rd, Rd, Gs, Aa, Aa, Aa, Aa, Aa, Aa, Aa, Aa, Aa, Aa^Fma, Aa, Aa, Aa, Aa, Gg, Gg, Gg, Gg
Gg, Gg, Gs, Aa, Aa, Aa, Aa, Aa, Aa, Gg, Gs, Rd, Rd, Rd, Aa, Aa, Aa, Aa^Fma, Aa, Aa, Aa, Aa, Aa, Aa, Aa, Aa, Aa, Aa, Gg, Gg, Gs, Gg
Gg, Gs, Aa, Aa, Aa, Aa, Aa, Aa, Gg, Gg, Gg, Gg, Rd, Rd, Cea, Aa, Aa, Aa, Gs, Aa, Aa, Aa, Aa, Aa, Aa, Aa, Aa, Aa, Aa, Gg, Gg, Gg
Gg, Aa, Aa, Aa, Aa, Aa, Aa, Aa, Gs, Gg, Gs, Gg, 1 Ke, Ce, Cea, Aa, Aa, Aa, Gs, Aa, Aa, Aa, Aa, Aa, Aa, Aa, Aa, Aa^Fma, Aa, Aa, Gg, Gg
Gg, Aa, Aa, Aa, Aa, Aa, Aa, Gg, Gg, Gg, Gg, Gg, Cea, Ce, Cea, Aa, Aa, Aa, Gs, Aa, Aa, Aa, Aa, Aa, Aa, Aa, Aa, Aa, Aa, Aa, Aa, Gs
Gg, Aa, Aa, Aa, Aa, Aa, Aa, Aa, Aa, Gg, Aa, Aa, Cea, Cea, Aa, Aa, Aa, Aa, Aa, Aa, Aa, Aa, Aa, Aa, Aa, Aa, Aa, Aa, Ai, Aa, Ai, Ai
Gg, Aa, Aa, Aa, Aa, Aa^Fma, Aa, Aa, Aa, Aa, Aa, Aa, Aa, Aa, Aa, Aa, Aa, Aa, Aa, Aa, Rp, Aa, Rp, Rp, Aa, Aa, Ai, Ai, Wwr, Ai, Wwr, Wwr
Gg, Aa, Aa, Aa, Aa, Aa, Aa, Aa, Aa, Aa, Aa, Aa, Aa, Aa, Aa, Aa, Aa, Aa, Aa, Aa, Rp, Rp, Rp, Aa, Ai, Ai, Wwr, Wwr, Wo, Wwr, Wwr, Wo
Gg, Gg, Gg, Aa, Gg, Aa, Aa, Aa, Aa, Aa, Aa, Aa, Aa^Fma, Aa, Aa, Aa, Aa, Aa, Aa, Aa, Rp, Rp, Ai, Ai, Wwr, Wwr, Wo, Wo, Ai, Wo, Ai, Ai
Aa, Gg, Gs, Gg, Gs, Gg, Aa, Aa^Fma, Aa, Aa, Aa, Aa, Aa, Aa, Aa, Aa, Aa, Aa, Aa, Rp, Ai, Ai, Wwr, Wwr, Wo, Wo, Wwr, Wwr, Ai, Ai, Gg, Gg
Aa, Aa, Aa, Gg, Gg, Gg, Aa, Aa, Aa, Aa, Aa, Aa, Rd, Aa, Aa, Aa, Aa^Fma, Aa, Aa, Ai, Wwr, Wwr, Wo, Wo, Wwr, Ai, Ai, Ai, Gg, Gg, Gs, Gg
Aa, Aa, Aa, Aa, Aa, Aa, Ha, Aa, Aa, Aa, Gg, Gs, Rd, Aa, Aa, Aa, Aa, Aa, Ai, Ai, Wwr, Wo, Wwr, Wwr, Ai, Ai, Aa^Fma, Ha^Fda, Gg, Gg, Gg, Gg
Aa, Aa, Aa, Aa, Aa, Ha, Ms, Ha, Aa, Aa, Gs, Gg, Rd, Aa, Aa, Aa, Aa, Aa, Ai, Wwr, Wo, Wo, Ai, Ai, Aa, Aa, Aa, Aa, Gg, Gg, Gg, Gg
Aa, Aa, Aa, Aa, Aa, Aa, Aa, Ha, Ha, Aa, Aa, Gg, Aa, Aa, Ai^Bw\, Aa^Bw\, Ai^Bw\, Ai, Wo, Wo, Wwr, Wwr, Ai, Aa, Ha, Aa, Aa, Aa, Gg, Gg, Gg, Gg
Gs, Aa, Aa, Aa, Aa^Fma, Aa, Aa, Aa, Aa, Aa, Aa, Aa, Ai, Ai, Wwr, Ai^Bw\, Wwr^Bw\, Wwr^Bw\, Wwr^Bw\, Wwr, Ai, Ai, Ha, Ha, Chw, Ha, Ha, Aa, Gg, Gs, Gg, Gg
Aa, Gg, Gg, Aa, Aa, Aa, Aa, Aa, Aa, Aa^Fma, Aa, Aa, Ai, Wwr, Wwr, Wwr, Wo, Wo^Bw\, Wo^Bw\, Wwr^Bw\, Ai^Bw\, Aa, Ha, Chw, 2 Khw, Chw, Ha, Aa, Gg, Gg, Gg, Gg
Aa, Aa, Aa, Gs, Gg, Gs, Aa, Aa, Aa, Aa, Ai, Ai, Wwr, Wwr, Wo, Wo, Wwr, Wwr, Ai, Wwr^Bw\, Aa, Aa, Ha, Chw, Chw, Chw, Ha, Aa, Aa, Gg, Gs, Gg
Aa, Aa, Aa, Gs, Gg, Gg, Aa, Aa, Ai, Ai, Wwr, Wwr, Wo, Wo, Wwr, Wwr, Ai, Ai, Aa, Gg, Gg, Aa, Aa, Ha, Ha, Ha, Aa, Aa, Aa, Aa, Aa, Gg
Aa, Aa, Aa, Gg, Gg, Gg, Gs, Aa, Ai, Wwr, Wo, Wo, Wo, Wwr, Wwr, Ai, Aa, Aa, Aa^Fma, Aa, Gg, Gg, Aa, Aa, Aa, Aa, Aa^Fma, Aa, Aa, Aa, Aa^Fma, Gg
Aa, Aa, Gg, Gg, Gg, Ai, Ai, Ai, Wwr, Wwr, Wo, Wo, Wo, Wwr, Ai, Ai, Ha, Ha, Aa, Aa, Gg, Gg, Gg, Aa, Aa, Aa, Aa, Aa, Aa, Aa, Aa, Gg
Gs, Gg, Gg, Gs, Ai, Ai, Wwr, Wwr, Wo, Wo, Wo, Wo, Wwr, Wwr, Ai, Aa, Ha, Ha, Ha, Aa, Gg, Gg, Gg, Gg, Gg, Aa, Gg, Aa, Aa, Aa, Gg, Gg
