Re, Re, Re, Re, Re, Re, Aa, Re, Rb, Re, Aa, Re, Aa, Re, Hh, Hh, Hh, Hh, Hh, Hh, Ms, Ms, Ms, Ms, Ms, Ms, Ms, Ms, Ms^Xm, Ms^Xm, Ms^Xm, Ms
Re, Re, Gll^Fdw, Gll^Fdw, Gll^Fdw, Re, Aa, Aa, Aa, Aa, Aa, Aa, Aa, Aa, Re, Hh, Hh, Hh, Re^Vct, Hh, Mm, Ms, Ms, Ms, Ms, Ms, Ms^Xm, Ms^Xm, Mm^Xm, Ms^Xm, Mm^Xm, Ms^Xm
Ai, Re, Gll^Fdw, Gll^Fdw, Gll^Fdw, Re, Aa, Aa, Aa, Re^Vct, Re, Aa, Aa, Rb, Re^Vct, Re, Rb, Hh, Gll^Fdw, Hh, Hh, Ms, Ms, Ms, Ms, Ms, Xu, Xu, Xu, Mm^Xm, Xu, Mm
Wwr, Ai, Ai, Gll^Fdw, Re^Vct, Re, Aa, Aa, Cea, Cea, Cea, Re, Rb, Aa, Aa, Aa, Re, Gll^Fdw, Gll^Fdw, Gll^Fdw, Ha, Hh, Hh, Mm^Vc, Xu, Xu, Cud, Uu^Vu, 3 Kud, Xu, Xu, Mm
Ai, Wwr, Ai, Ai, Ai, Re, Re, Aa, Cea, 1 Kea, Cea, Aa, Rb, Aa, Aa, Aa, Re, Gll^Fdw, Gll^Fdw, Gll^Fdw, Hh, Ha, Ha, Hh, Hh, Urb, Urb, Cud, Cud, Uu^Vu, Cud, Xu
Re, Ai, Ai, Ai, Wwr, Ai, Ai, Aa, Aa, Cea, Aa, Aa, Rb, Rb, Re, Re, Re, Re, Rd, Hh, Hh, Hh, Hh, Ha, Hh, Hh, Hh, Urb, Urb, Cud, Uu^Vu, Xu
Re, Re, Re, Ai, Wwr, Wwr, Ai, Ai, Ai, Aa, Re, Re^Vct, Re, Rb, Re, Re^Vct, Re, Aa, Rd, Hh, Rd, Hh, Ha, Ha, Ha, Hh, Hh, Hh, Hh, Urb, Xu, Xu
Re, Re, Re, Re, Aa, Ai, Ai, Ai, Ai, Ai, Ai, Re, Aa, Aa, Aa, Wo, Wo, Aa, Aa, Rd, Aa, Ha, Hh, Ha, Ha, Aa, Hh, Hh, Hh, Hh, Hh, Mm
Re, Re, Re, Re, Aa, Aa, Ai, Wwr, Wwr, Wo, Wo, Aa, Wo, Aa, Wo, Wo, Wo, Wo, Aa, Aa, Re, Aa, Re, Hh, Ha, Hh, Hh, Hh, Re^Vct, Hh, Hh, Hh
Re, Re, Re, Re^Vct, Ai, Wwr, Wwr, Ai, Ai, Ai, Re, Aa, Wo, Wo, Aa^Vca, Aa, Aa, Aa, Dyb, Aa, Aa, Re, Re, Rd, Ha, Ha, Hh, Ha, Ha, Hh, Ha, Ha
Re, Re, Ai, Ai, Wwr, Wwr, Ai, Ai, Aa, Re, Re, Aa, Aa, Aa, Aa, Aa, Aa, Dyb, Dyb, Dyb, Aa, Re^Vct, Aa, Re, Hhd, Hh, Hhd, Ha, Hh, Hh, Hh, Ha
Ai, Ai, Wwr, Ai, Ai, Ai, Aa, Aa, Aa, Re, Re, Re, Re, Aa, Re, Aa, Aa, Aa, Aa, Aa, Aa, Aa, Re, Aa, Aa, Hhd, Hhd, Hhd, Hhd, Hhd, Hhd, Hh
Wwr, Wwr, Ai, Ai, Aa, Aa, Dyb, Aa, Aa, Aa^Voa, Aa, Re, Re, Re, Re, Re, Re, Re, Ha, Aa, Re, Re, Re, Gll^Fdw, Gll^Fdw, Hh, Ha, Hhd, Hhd, Hhd, Hhd, Hhd
Ai, Ai, Aa, Aa, Aa, Dyb, Dyb, Dyb, Aa, Aa, Aa, Aa, Aa, Re, Aa^Vca, Re, Aa, Re, Ha, Ha, Re, Re, Gll^Fdw, Gll^Fdw, Gll^Fdw, Hh, Aa^Voa, Ha, Ha, Hhd, Hhd, Hhd
Gg, Gg, Aa, Aa, Aa, Aa, Aa, Aa, Aa, Aa, Dyb, Dyb, Dyb, Aa, Aa, Aa, Dyb, Aa, Aa^Vha, Ha, Aa, Gll^Fdw, Gll^Fdw, Gll^Fdw, Hhd^Fdw, Hh, Hh, Ha, Hh, Hh, Re, Hhd
Aa, Aa, Aa, Aa, Ha, Ha, Ha, Aa, Aa, Aa, Aa, Dyb, Aa, Aa, Aa, Dyb, Dyb, Dyb, Aa, Ha, Ha, Gll^Fdw, Gll^Fdw, Hhd^Fdw, Ha, Hhd^Fdw, Hh, Hh, Re, Re, Re, Re
Aa, Aa^Voa, Aa, Aa, Aa, Ha, Aa, Aa, Dyb, Dyb, Dyb, Aa, Ha, Ha, Aa, Aa, Aa, Aa, Aa, Ha, Aa, Aa, Aa, Ha, Ha, Ha, Aa, Re, Re, Re, Aa, Re
Aa, Aa, Aa, Aa, Aa, Aa, Aa, Aa, Aa, Dyb, Aa^Voa, Aa, Aa, Aa, Aa, Aa, Aa, Ha, Ha, Aa, Ai, Ai, Ha, Ha, Ha, Ha, Aa, Aa, Re, Re, Aa, Re
Ss, Aa, Aa, Aa, Aa, Aa, Gll^Fdw, Gll^Fdw, Gll^Fdw, Aa, Aa, Aa, Rd, Rd, Rd, Rd, Rd, Hhd, Hhd, Ai, Ha, Ha, Ha, Aa, Aa, Aa, Aa, Aa, Aa, Aa, Aa, Re
Ss, Ss, Ai, Aa, Aa, Aa, Gll^Fdw, Gll^Fdw, Gll^Fdw, Ds^Dr, Aa, Aa, Rd^Dr, Rd, Rb, Rb, Rd, Rd, Rd, Hh, Hh, Ha, Ai, Aa, Aa^Voa, Aa, Aa, Re, Re, Aa, Re, Re
Ss, Ai, Ai, Ai, Aa, Ai, Ss, Gll^Fdw, Ss, Gd, Gd, Gd, Gd^Vhr, Rd, Rb, Rb, Rd^Dr, Rd, Rd, Rd, Rd, Hh, Ai, Aa, Aa, Aa, Aa^Dr, Dd^Dc, Ds, Ds, Dd^Vdt, Re
Ss, Ai, Ai, Aa^Voa, Ai, Ai, Ss, Ss, Ss, Gd, Gd, Gd, Rd, Rd, Rd, Rd, Rd, Rd, Gd, Rb, Rb, Rd, Rd, Aa^Dr, Ds, Ds, Rd, Gd, Gd^Vhr, Gd, Gd, Re
Ss, Ai, Ai, Ai, Ai, Ai, Ss, Ss, Dd^Vdt, Ds^Dr, Rd, Rd, Hhd, Rd, Rd, Rd, Rd, Gd, Gd^Vhr, Gd, Gd, Rb, Rd, Rd, Rd, Rd, Rd, Rd, Rd, Rd, Rd, Gd
Ss, Ss, Ss, Ai, Ss^Vhs, Ss, Ss, Ss, Rd, Rd, Rd, Hhd^Vhhr, Hhd, Hhd, Rd, Rd, Rd, Rd^Dr, Rd, Rd, Rd, Rd, Rd, Rd, Rd^Dr, Rd, Rd, Rd, Hhd, Rd, Rd, Rd
Ss, Ss, Gs^Fdw, Gs^Fdw, Gs^Fdw, Ss, Rd, Rd, Rd, Rd, Rd, Hhd, Hhd, Hhd, Rd, Rd, Rd, Rd, Rd, Rd, Rd, Rd^Dr, Rd, Rd, Rd, Rd, Hhd, Hhd, Rd^Dr, Rd, Rd, Rd
Rd, Rd, Rd, Rd, Rd, Rd, Hhd, Rd, Hhd, Rd, Hhd^Fdw, Hhd, Hhd, Hhd, Rd, Rd, Rd, Rd, Hhd^Fdw, Rd, Hhd^Fdw, Rd, Rd, Rd, Rd, Rd, Rd, Rd, Rd, Rd, Hhd, Rd
Rd, Rd, Rd, Rd, Hhd, Hhd, Hhd, Hhd, Hhd, Hhd^Fdw, Hhd, Hhd, Hhd, Hhd^Vhhr, Rd, Rd, Rd, Hhd, Hhd^Dr, Hhd^Fdw, Hhd, Hhd, Hhd, Rd, Hhd, Rd, Rd, Rd, Rd, Hhd, Rd, Rd
Rd, Rd, Hhd, Hhd^Dr, Hhd, Hhd, Hhd, Hhd^Vhhr, Hhd, Hhd^Fdw, Hhd, Hhd^Dr, Rd, Rd, Rd, Rd, Rd, Hhd^Dr, Hhd, Hhd, Hhd, Hhd, Hhd^Vhhr, Hhd, Hhd, Hhd, Hhd, Rd, Hhd^Vhhr, Hhd, Rd, Rd
Hhd, Hhd, Hhd, Hhd, Hhd, Hhd, Hhd, Hhd, Rd, Hhd, Dd, Rd, Dd, Rd, Rd, Rd, Rd, Rd, Rd, Hhd, Rd, Hhd, Hhd, Hhd, Hhd, Hhd^Fdw, Hhd^Dr, Hhd, Hhd, Hhd, Rd, Rd
Hhd, Hhd, Hhd, Hhd, Hhd, Hhd, Rd, Rd, Rd, Rd, Dd, Dd, Dd, Dd, Dd, Dd, Dd, Rd, Rd, Rd, Rd, Rd, Rd, Hhd, Rd, Hhd, Hhd, Hhd, Hhd, Hhd, Rd, Rd
Hhd, Hhd, Hhd, Hhd, Gd, Rd, Rd, Rd, Rd, Dd, Ql, Dd^Edp, Ql, Dd^Dr, Ql^Bsb|, Dd^Dr, Dd, Dd^Dr, Dd, Rd, Rd, Rd^Dr, Rd, Rd, Rd, Rd, Rd, Hhd, Rd, Rd, Rd, Rd
Hhd, Hhd, Rd, Gd, Gd^Vhr, Rd, Rd, Rd, Dd^Edp, Dd, Ql, Ql, Ql, Ql, Dd^Dr, Ql, Ql, Ql, Ql, Dd^Edp, Dd, Rd, Rd, Gd, Gd^Vhr, Gd, Rd, Rd, Rd, Rd, Rd^Dr, Rd
Rd, Rd, Rd^Dr, Gd, Gd, Rd, Rd, Rd, Dd, Ql, Ql, Ql, Ql, Dd^Dr, Ko, Dd^Dr, Ql, Ql, Ql, Dd, Dd, Dd, Rd^Edp, Gd, Gd, Gd, Rd, Rd, Rd, Rd, Rd, Rd
Rd, Rd, Rd, Rd, Rd^Dr, Rd, Rd, Dd, Dd^Dr, Ql, Dd^Dr, Ql, Co, Co, Co, Co, Co, Ql, Dd^Dr, Ql, Dd, Dd, Rd, Gd, Rd, Rd, Dd, Rd, Rd, Rd, Rd, Rd
Rd, Hhd, Hhd^Fdw, Rd, Rd, Rd, Rd, Dd, Dd^Dr, Ql^Bsb/, Dd^Dr, Ko, Co, Ch, Co, Ch, Co, Ko, Dd^Dr, Ql^Bsb\, Dd^Dr, Dd, Dd^Dr, Rd, Dd, Dd, Ql, Dd, Dd, Rd, Rd, Rd
Rd, Hhd, Ss, Hhd, Rd, Rd, Rd^Dr, Dd, Ql, Ql, Ql, Co, Ch, Co, 2 Ko, Co, Ch, Co, Ql, Ql, Ql, Dd, Ql, Dd, Ql, Ql, Ql, Ql, Ql, Dd, Dd, Rd
Rd, Hhd, Ss, Hhd^Fdw, Hhd, Rd, Rd, Dd, Dd, Ql, Ql, Co, Ch, Co, Ch, Co, Ch, Co, Dd^Dr, Ql, Dd^Dr, Ql, Ql, Ql, Dd, Dd, Dd, Dd, Dd, Ql, Ql, Dd
Rd, Hhd, Ss, Ss, Ss, Hhd, Hhd, Dd, Dd^Dr, Ql, Ql^Dr, Ko, Co, Ch, Co, Ch, Co, Ko, Dd^Dr, Ql, Ql, Dd, Dd, Dd^Edp, Dd, Dd, Gd, Dd, Dd, Dd, Dd, Ql
Rd, Hhd, Hhd^Fdw, Wog, Wog, Ss, Hhd, Hhd, Dd^Dr, Ql, Ql, Ql, Ql, Co, Ko, Co, Dd, Ql, Ql, Ql^Bsb\, Dd^Dr, Dd^Dr, Dd, Dd, Gd, Gd, Gd, Gd, Ss^Vhs, Dd, Dd, Dd
Rd, Hhd, Hhd, Ss, Ss, Ss, Ss, Hhd, Hhd, Dd^Dr, Dd, Ql, Ql, Dd, Ql, Dd, Ql, Ql, Dd, Dd^Dr, Dd, Dd, Rd, Rd, Ss, Ss^Vhs, Ss, Ss, Wog, Ss, Ss^Vhs, Dd
Rd, Rd, Rd, Hhd, Hhd, Ss, Hhd, Hhd, Rd, Rd, Rd, Dd, Dd, Ql, Ql, Ql, Dd, Dd, Dd, Dd, Gd, Rd, Ss^Vhs, Ss, Wog, Wog, Ss, Ss^Vhs, Ss, Ss, Wog, Ss
Rd, Rd, Rd, Hhd, Hhd, Hhd, Rd, Rd, Rd, Rd, Rd, Rd, Dd, Dd, Dd, Dd, Dd, Dd, Dd, Gd, Gd, Ss, Ss, Ss, Ss, Ss, Ss, Ss, Ss, Ss, Ss, Ss
