Re, Re, Re, Re, Re, Re, Re, Re, Re^Vct, Re, Re, Re, Re, Re, Re, Re, Re, Re, Re, Re, Mm, Mm, Mm, Mm, Mm, Mm, Mm, Gg, Mm, Mm, Mm, Mm
Re, Re, Gs^Fdw, Gs^Fdw, Gs^Fdw, Re, Re, Re, Re, Re, Re, Re, Re, Re, Re, Re, Re, Re, Re^Vct, Re, Mm, Mm, Mm, Mm, Mm, Mm, Mm, Mm, Mm, Mm, Mm, Mm
Ai, Re, Gs^Fdw, Gs^Fdw, Gs^Fdw, Re, Re, Re, Ce, Re, Ce, Re, Ce, Re, Re, Re, Re, Re, Gs^Fdw, Re, Re, Mm, Mm, Mm, Mm, Mm, Mm, Mm^Vhh, Xu, Mm, Mm^Vhh, Mm
Wwr, Ai, Ai, Gs^Fdw, Re^Vct, Re, Re, Re, Ce, Ce, 1 Ke, Ce, Ce, Re, Re, Re, Re, Gs^Fdw, Gs^Fdw, Gs^Fdw, Re, Hh, Hh, Mm^Vc, Mm, Mm^Vhh, Cud, Xu, 3 Kud, Xu, Xu, Mm
Ai, Wwr, Ai, Ai, Ai, Re, Re, Re, Ce, Ce, Ce, Ce, Ce, Re, Re, Re, Re, Gs^Fdw, Gs^Fdw, Gs^Fdw, Re, Re, Hh, Hh, Hh, Mm, Mm, Cud, Cud, Xu, Cud, Mm
Re, Ai, Ai, Ai, Wwr, Ai, Ai, Re, Re, Re, Re, Re, Re, Re, Re, Re, Re, Re, Rd, Rd, Hh, Hh, Hh, Hh, Hh, Hh, Hh, Mm, Mm, Cud, Mm^Vhh, Mm
Re, Re, Re, Ai, Wwr, Wwr, Ai, Ai, Ai, Re, Re, Re^Vct, Re, Re, Re, Re^Vct, Re, Aa, Rd, Hh, Rd, Rd, Ha, Ha, Ha, Hh, Hh, Hh, Hh, Mm, Mm, Mm
Re, Re, Re, Re, Aa, Ai, Ai, Ai, Ai, Ai, Ai, Re, Aa, Aa, Aa, Re, Re, Aa, Aa, Rd, Aa, Ha, Ha, Ha, Ha, Aa, Hh, Hh, Hh, Hh, Hh, Mm
Re, Re, Re, Re, Aa, Aa, Ai, Wwr, Wwr, Ai, Ai, Aa, Re, Aa, Re, Re, Re, Re, Aa, Aa, Re, Aa, Re, Ha, Rd, Rd, Rd, Hh, Re^Vct, Hh, Hh, Hh
Re, Re, Re, Re^Vct, Ai, Wwr, Wwr, Ai, Ai, Ai, Re, Aa, Re, Re, Aa^Vha, Aa, Re, Re, Re, Aa, Re, Re, Re, Rd, Rd, Rd, Aa, Aa, Aa, Aa, Aa, Hh
Re, Re, Ai, Ai, Wwr, Wwr, Ai, Ai, Aa, Re, Re, Aa, Aa, Aa, Aa, Aa, Re, Re, Re, Re, Re, Re^Vct, Re, Re, Re, Aa, Aa, Aa, Aa, Aa, Aa, Aa
Ai, Ai, Wwr, Ai, Ai, Ai, Aa, Aa, Dd, Re, Re, Re, Re, Aa, Re, Re, Re, Re, Re, Re, Re, Re, Re, Re, Re, Re, Re, Aa, Aa, Aa, Aa^Vha, Aa
Wwr, Wwr, Ai, Ai, Aa, Aa, Aa, Dd, Dd^Dc, Dd^Vdt, Dd, Re, Re, Re, Re, Re, Re, Re, Hh, Re, Re, Re, Re, Gs^Fdw, Gs^Fdw, Re, Re, Aa, Aa, Aa, Aa, Aa
Ai, Ai, Aa, Aa, Aa, Aa, Aa, Dd, Dd, Dd, Dd, Dd, Hd, Re, Re^Vct, Re, Dd^Vdt, Re, Hh, Hh, Re, Re, Gs^Fdw, Gs^Fdw, Gs^Fdw, Re, Re^Vct, Re, Re, Aa, Re, Re
Gg, Gg, Aa, Aa, Aa, Aa, Ha, Dd, Dd, Dd, Hd, Hd, Hd, Hd, Hd, Dd, Dd, Re, Aa^Vha, Ha, Aa, Gs^Fdw, Gs^Fdw, Gs^Fdw, Re, Re, Re, Re, Re, Re, Re, Re
Aa, Aa, Aa, Aa, Aa, Ha, Ha, Dd^Dc, Dd, Dd, Dd, Hd, Hd, Hd, Dd, Dd^Dc, Dd, Aa, Aa, Ha, Ha, Gs^Fdw, Gs^Fdw, Re, Aa, Re, Re, Re, Re, Re, Re, Re
Aa, Aa^Vha, Aa, Aa, Aa, Ha, Dd, Dd, Dd, Dd^Vdt, Dd, Dd, Dd, Dd, Ds^Dr, Dd, Dd, Aa, Aa, Ha, Aa, Aa, Aa, Aa, Aa, Aa, Aa, Re, Re, Re, Re, Re
Aa, Aa, Aa, Aa, Aa, Dd, Dd, Dd, Dd, Dd^Dc, Dd, Dd, Ds^Dr, Ds^Dr, Ql^Bs|, Ds^Dr, Ds^Dr, Aa, Aa, Aa, Ai, Ai, Ai, Aa, Aa, Aa, Aa, Re, Re, Re, Re, Re
Ss, Aa, Aa, Aa, Dd, Dd^Dc, Gll^Ftr, Gll^Ftr, Gll^Ftr, Dd, Ds^Dr, Ds^Dr, Ql, Ql, Ko, Ql, Ql, Ds^Dr, Ds^Dr, Ai, Ss, Ss, Ai, Aa, Aa, Aa, Aa, Re, Re, Re, Re^Vct, Re
Ss, Ss, Ai, Aa, Aa, Dd, Gll^Ftr, Gll^Ftr, Gll^Ftr, Ds^Dr, Ql^Bs\, Ql, Co, Co, Co, Co, Co, Ql, Ql^Bs/, Ds^Dr, Ss, Ss, Ai, Aa, Dd^Vdt, Aa, Aa, Re, Re, Re, Re, Re
Ss, Ai, Ai, Ai, Aa, Ai, Ss, Gll^Ftr, Ss, Ds^Dr, Ql, Ko, Co, Chr, Co, Chr, Co, Ko, Ql, Ds^Dr, Ds^Dr, Ss, Ai, Aa, Aa, Aa, Aa^Dr, Dd^Dc, Ds, Ds, Dd^Vdt, Re
Ss, Ai, Ai, Aa^Vha, Ai, Ai, Ss, Ss, Ss, Ds^Dr, Ql, Co, Chr, Co, 2 Ko, Co, Chr, Co, Ql, Ql, Ql, Ds^Dr, Ds, Aa^Dr, Ds, Ds, Ql, Gs, Gs, Gg^Dr, Gs, Re
Ss, Ai, Ai, Ai, Ai, Ai, Ss, Ss, Dd^Vdt, Ds^Dr, Ql, Co, Co, Co, Co, Co, Co, Co, Ql, Ds^Dr, Ss, Ql, Ql, Dd^Dc, Ql, Ql, Gs, Ql, Ql, Ql, Ql, Gg^Dr
Ss, Ss, Ss, Ai, Ss^Vhs, Ss, Ss, Ss, Ss, Ds^Dr, Ql^Bs/, Ko, Co, Chr, Co, Chr, Co, Ko, Ql^Bs\, Ds^Dr, Dd^Vdt, Ss, Gg^Dr, Ql, Gg^Efm, Gg^Dr, Ss, Gg^Dr, Gs, Gg^Efm, Gg^Dr, Ql
Ss, Ss, Gll^Ftr, Gll^Ftr, Gll^Ftr, Ss, Ss, Ss, Ss, Ds^Dr, Ds^Dr, Ql, Ql, Co, Ko, Co, Ql, Ql, Ds^Dr, Ds^Dr, Ss, Ss, Ss, Gs, Ss, Ss, Ss, Ss, Ss, Ss, Gs, Ql
Ss, Ss, Gll^Ftr, Gll^Ftr, Gll^Ftr, Ss, Ss^Vhs, Ss, Ss, Ss, Ss, Ds^Dr, Ds^Dr, Ql, Ql, Ql, Ds^Dr, Ds^Dr, Ss, Ss, Ss, Ss, Ss, Ss, Ss, Ss, Ss, Ss^Vhs, Ss, Ss, Gg^Dr, Ql
Ss, Ss, Ss, Gll^Ftr, Ss, Ss, Ss, Ss, Ss, Ss, Ss, Ss, Ss, Ds^Dr, Ds^Dr, Ds^Dr, Ss, Ss, Ss, Ss, Ss, Ss, Ss, Ss, Ss, Ss, Ss, Ss, Ss, Ss, Gs, Ql
