Gg, Gg, Gg, Gg, Gg, Gg, Gg, Gg, Gg, Gg, Gg, Gg, Gg, Gg, Gg, Gg, Gg, Gg, Gg, Gg, Gg, Gg, Aa, Aa, Aa, Aa, Aa, Gg, Gg, Gg, Gg, Gg, Gg, Gg, Gg
Gg, Gg, Gg, Gg, Ce, Gg, Gg, Gg, Gg, Gg, Gg, Gg, Gg, Gg, Aa, Gg, Gg, Gg, Aa^Fda, Gg, Gg, Gg, Aa, Aa, Aa, Aa, Aa, Gg, Aa, Aa, Aa, Gg, Gg, Gg, Gg
Gg, Gg, Gg, Ce, 1 Ke, Ce, Gg, Gg, Gg, Gg, Gg, Gg, Aa, Aa, Aa, Aa, Aa, Aa^Fda, Aa^Fpa, Aa^Fda, Aa, Gg, Aa, Aa, Aa, Aa, Aa, Aa, Aa, Aa, Aa, Aa, Gg, Gg, Gg
Gg, Gg, Aa, Cea, Cea, Cea, Aa, Aa, Aa, Gg, Gg, Gg, Aa, Aa, Aa, Aa, Aa, Aa^Fda, Aa^Fda, Aa^Fda, Aa, Aa, Gg, Aa, Aa, Aa, Gg, Aa, Aa, Aa, Aa, Aa, Gg, Gg, Gg
Aa, Aa, Aa, Aa, Aa, Aa, Aa, Aa, Aa, Aa, Gg, Gg, Aa, Aa, Aa, Aa, Aa, Aa, Aa, Aa, Aa, Aa, Aa^Fpa, Aa^Fda, Aa^Fda, Gg, Aa^Fda, Aa^Fda, Aa^Fda, Aa, Aa, Aa, Gg, Gg, Gg
Aa, Aa, Aa, Aa, Aa, Aa, Aa, Aa, Aa, Aa, Gg, Gg, Aa, Aa, Aa, Aa, Gg, Aa, Aa, Aa, Aa, Aa, Aa^Fda, Aa^Fda, Aa^Fda, Aa^Fda, Aa^Fpa, Aa^Fda, Aa^Fda, Aa, Aa, Gg, Gg, Gg, Gg
Aa, Aa, Aa, Aa, Aa, Aa, Aa, Aa, Aa^Fpa, Aa, Aa, Aa, Aa, Aa, Aa, Gg, Aa^Fpa, Gg, Aa, Aa, Aa^Fpa, Gg, Aa, Aa^Fda, Aa^Fda, Aa^Fda, Aa, Aa^Fda, Aa, Aa, Aa, Aa, Aa, Gg, Gg
Gg, Aa, Aa, Aa, Gg, Gg, Aa, Aa^Fda, Aa^Fda, Aa^Fpa, Aa^Fpa, Aa, Aa, Aa, Aa, Aa^Fpa, Aa^Fpa, Aa^Fpa, Aa^Fpa, Aa^Fpa, Aa^Fpa, Aa^Fpa, Aa, Aa, Aa, Aa, Aa, Gg, Aa, Aa, Aa, Aa, Aa, Gg, Gg
Gg, Gg, Gg, Gg, Gg, Gg, Aa, Aa^Fda, Aa^Fda, Aa^Fpa, Aa, Aa, Aa, Aa, Aa, Aa^Fpa, Aa^Fpa, Aa^Fpa, Aa^Fpa, Aa^Fpa, Aa^Fpa, Aa^Fpa, Aa, Aa, Aa, Aa, Aa, Gg, Aa^Fda, Aa^Fda, Aa^Fda, Aa, Aa, Aa, Aa
Gg, Gg, Gg, Gg, Aa, Aa, Aa, Aa, Aa, Aa, Gg, Aa, Aa, Aa, Gg, Gg, Aa, Aa^Fpa, Aa^Fpa, Aa^Fpa, Aa, Gg, Gg, Aa, Aa, Aa, Gg, Aa^Fpa, Aa^Fda, Aa^Fda, Aa^Fda, Aa, Aa, Aa, Aa
Gg, Gg, Gg, Aa, Aa, Aa, Aa, Aa, Gg, Gg, Gg, Gg, Aa, Gg, Gg, Gg, Gg, Aa, Aa, Aa, Gg, Gg, Gg, Gg, Aa, Gg, Gg, Aa^Fda, Aa^Fda, Aa^Fpa, Aa^Fda, Aa, Aa, Aa, Aa
Aa, Aa, Aa, Aa, Aa, Aa, Aa, Aa, Gg, Gg, Aa, Aa, Aa, Aa, Aa^Fda, Gg, Aa, Aa, Aa, Gg, Gg, Gg, Aa, Aa, Aa, Aa, Aa, Aa^Fda, Aa^Fpa, Aa^Fda, Aa^Fda, Aa^Fda, Aa, Aa, Aa
Aa, Aa, Aa, Aa, Aa^Fda, Aa, Aa, Aa, Gg, Gg, Aa, Aa, Aa^Fda, Aa^Fda, Aa^Fda, Aa^Fda, Aa, Aa, Aa, Aa, Gg, Gg, Aa, Aa, Aa, Aa, Aa, Aa, Gg, Aa^Fda, Aa^Fda, Aa^Fpa, Aa, Aa, Gg
Aa, Aa, Aa, Aa^Fda, Aa^Fda, Aa^Fda, Gg, Gg, Gg, Gg, Aa, Aa, Aa^Fpa, Aa^Fda, Aa^Fda, Aa^Fda, Aa, Aa, Aa^Fda, Aa^Fda, Aa^Fda, Aa, Aa, Aa, Aa, Aa, Aa, Aa, Gg, Aa, Aa, Aa, Aa, Aa, Gg
Aa, Aa, Aa, Aa^Fda, Aa^Fpa, Aa^Fda, Aa^Fda, Gg, Gg, Gg, Gg, Aa, Aa, Aa^Fda, Aa^Fda, Aa^Fda, Aa, Aa, Aa^Fda, Aa^Fda, Aa^Fpa, Aa^Fda, Aa^Fda, Aa, Aa, Aa, Aa, Aa, Gg, Aa, Aa, Aa, Aa, Aa, Gg
Gg, Aa, Aa, Aa, Aa^Fda, Aa^Fda, Aa^Fda, Gg, Gg, Gg, Gg, Gg, Aa, Aa, Aa, Aa, Aa, Aa, Aa, Aa^Fda, Aa^Fpa, Aa^Fda, Aa^Fda, Aa, Aa, Aa, Gg, Gg, Gg, Aa, Aa, Aa, Aa, Aa, Aa
Gg, Aa, Aa, Aa, Aa, Aa^Fda, Aa, Aa, Aa, Gg, Aa^Feta, Gg, Aa, Aa, Aa^Fda, Aa^Fda, Aa^Fda, Aa, Aa, Aa^Fda, Aa^Fda, Aa^Fda, Aa, Aa, Aa, Aa, Gg, Gg, Gg, Gg, Aa, Aa, Aa, Aa, Aa
Gg, Aa, Aa, Aa, Aa, Aa, Aa, Aa, Aa, Aa, Aa, Gg, Aa, Aa^Fda, Aa^Fda, Aa^Fpa, Aa^Fda, Aa, Aa, Aa, Aa, Aa, Aa, Aa, Aa, Aa, Aa, Aa, Aa, Aa^Feta, Aa, Aa, Aa, Aa, Aa
Aa, Aa, Aa, Aa, Aa, Aa, Aa, Aa, Aa, Aa, Aa, Aa, Aa^Fda, Aa^Fda, Aa^Fda, Aa^Fda, Aa^Fda, Aa^Fda, Aa^Fda, 2 Aa^Feta, Gg, Aa, Gg, Aa, Gg, Aa, Aa, Aa, Aa, Aa, Gg, Aa, Aa, Aa, Gg
Aa, Aa, Aa, Aa, Aa, Aa, Aa, Aa, Aa, Aa, Aa, Aa, Aa^Fda, Aa^Fda, Aa^Fda, Gg, Aa^Fda, Aa^Fpa, Aa^Fda, Gg, Gg, Gg, Gg, Gg, Gg, Aa, Aa, Aa, Aa, Aa, Gg, Gg, Gg, Gg, Gg
Aa, Aa, Aa, Aa, Aa, Gg, Gg, Aa, Aa, Aa, Aa, Aa^Fpa, Aa, Aa^Fda, Gg, Gg, Gg, Aa^Fda, Gg, Gg, Gg, Gg, Gg, Gg, Gg, Aa, Aa, Aa, Aa, Aa, Gg, Gg, Gg, Gg, Gg
Gg, Aa, Aa, Aa, Gg, Gg, Gg, Gg, Gg, Aa, Aa, Aa, Gg, Gg, Gg, Gg, Gg, Gg, Gg, Gg, Gg, Gg, Gg, Gg, Gg, Gg, Gg, Aa, Gg, Gg, Gg, Gg, Gg, Gg, Gg
