Gs, Gs, Gs, Gs, Aa, Aa, Aa, Aa, Aa, Aa, Aa, Aa^Fma, Aa^Fma, Aa^Fma, Aa^Fma, Aa^Fma, Aa^Fma, Aa^Fma, Aa^Fma, Aa^Fma, Aa^Fma, Aa^Fma, Aa^Fma, Aa^Fma, Aa^Fma, Aa^Fma, Aa^Fma, Aa^Fma, Aa^Fma, Aa^Fma, Aa^Fma, Ai, Ai, Ai, Ai, Aa^Fma, Aa^Fma, Aa^Fma, Aa^Fma, Aa^Fma, Aa^Fma, Aa^Fma, Aa^Fma
Gs, Gs, Cea, Gs, Cea, Aa, Cea, Aa, Aa, Aa, Aa^Fma, Aa^Fma, Aa^Fma, Aa^Fma, Aa^Fma, Aa^Fma, Aa^Fma, Aa^Fma, Aa^Fma, Aa^Fma, Aa^Fma, Aa^Fma, Aa^Fma, Aa^Fma, Aa, Aa^Fma, Aa^Fma, Aa^Fma, Aa^Fma, Aa^Fma, Aa^Fma, Ai, Wwr, Wwr, Ai, Aa^Fma, Aa, Aa^Fma, Aa^Fma, Aa^Fma, Aa^Fma, Aa^Fma, Aa^Fma
Aa, Aa, Cea, Ce, 1 Ke, Cea, Ce, Re^Vct, Aa, Aa, Aa^Fma, Aa^Fma, Gs, Gs, Aa^Fma, Aa^Fma, Aa^Fma, Aa^Fma, Aa^Fma, Aa, Aa^Fma, Aa^Fma, Aa^Fma, Aa^Fma, Aa^Fma, Aa^Fma, Aa, Aa^Fma, Aa, Aa^Fma, Aa^Fma, Ai, Ww, Ww, Aa^Fma, Aa, Aa, Aa^Fma, Aa^Fma, Aa, Aa^Fma, Aa^Fma, Aa^Fma
Gs, Gs, Cea, Cea, Cea, Ce, Cea, Gs, Aa, Re^Vct, Aa^Fma, Aa^Fma, Aa^Fma, Aa^Fma, Aa^Fma, Aa^Fma, Aa, Aa^Fma, Aa^Fma, Aa^Fma, Aa^Fma, Aa^Fma, Aa^Fma, Aa^Fma, Aa^Fma, Aa, Aa^Fma, Aa, Aa^Fma, Aa, Aa, Ai, Ww, Ww, Aa^Fma, Aa^Fma, Aa^Fma, Aa, Aa^Fma, Aa^Fma, Aa, Aa^Fma, Aa^Fma
Aa, Re^Vct, Aa, Aa, Re^Vct, Gs, Aa, Aa, Aa^Fma, Aa^Fma, Aa^Fma, Aa^Fma, Aa^Fma, Aa^Fma, Aa, Aa^Fma, Aa, Aa, Aa, Aa, Aa^Fma, Aa, Aa^Fma, Aa^Fma, Aa^Fma, Aa^Fma, Aa^Fma, Aa^Fma, Aa^Fma, Aa^Fma, Aa^Fma, Ai, Wwr, Ai, Aa, Aa^Fma, Aa^Fma, Aa^Fma, Aa^Fma, Aa^Fma, Aa, Aa^Fma, Aa^Fma
Aa, Aa, Aa, Aa, Aa, Gs, Gs, Gs, Aa, Aa^Fma, Aa^Fma, Aa^Fma, Aa^Fma, Aa, Aa, Aa, Aa, Aa^Fma, Aa, Aa^Fma, Aa^Fma, Aa^Fma, Aa^Fma, Aa^Fma, Aa, Aa^Fma, Aa, Aa, Aa, Aa, Aa, Ai, Ai, Ai, Ai, Aa, Aa, Aa, Aa^Fma, Aa^Fma, Aa, Aa^Fma, Aa^Fma
Aa, Aa, Aa, Aa, Re^Vct, Aa, Aa^Fma, Aa^Fma, Aa^Fma, Aa, Gs, Aa^Fma, Aa^Fma, Aa^Fma, Aa, Aa, Aa^Fma, Aa^Fma, Aa^Fma, Aa, Aa^Fma, Aa^Fma, Aa, Aa^Fma, Aa, Aa^Fma, Aa^Fma, Aa^Fma, Aa^Fma, Aa^Fma, Aa, Ai, Ww, Ai, Ai, Aa, Aa, Aa^Fma, Aa, Aa, Aa^Fma, Aa^Fma, Aa^Fma
Aa^Fma, Aa, Aa^Fma, Aa^Fma, Aa^Fma, Aa^Fma, Aa^Fma, Aa^Fma, Aa^Fma, Aa^Fma, Aa^Fma, Gs, Aa, Aa^Fma, Aa^Fma, Aa, Aa^Fma, Aa^Fma, Aa^Fma, Aa^Fma, Aa^Fma, Aa^Fma, Aa, Aa, Aa, Aa, Aa^Fma, Aa^Fma, Aa, Aa^Fma, Aa^Fma, Aa^Fma, Ai, Wwr, Ww, Ai, Aa^Fma, Aa^Fma, Aa^Fma, Aa^Fma, Aa^Fma, Aa^Fma, Aa^Fma
Aa^Fma, Aa^Fma, Aa^Fma, Aa^Fma, Aa^Fma, Aa^Fma, Aa^Fma, Aa, Aa, Aa^Fma, Aa^Fma, Aa^Fma, Aa^Fma, Aa, Aa, Aa^Fma, Aa^Fma, Aa, Aa, Aa, Aa, Aa, Aa^Fma, Aa, Aa, Aa, Aa^Fma, Aa, Aa, Aa^Fma, Aa^Fma, Aa^Fma, Aa, Ww, Wwr, Ai, Aa, Aa, Aa^Fma, Aa^Fma, Aa^Fma, Aa^Fma, Aa^Fma
Aa^Fma, Aa^Fma, Aa^Fma, Aa^Fma, Aa, Aa, Aa, Aa, Aa^Fma, Aa^Fma, Aa^Fma, Aa^Fma, Aa, Aa, Aa, Aa, Aa, Aa^Fma, Aa, Aa, Aa, Aa, Aa, Aa, Aa, Aa^Fma, Aa, Aa, Aa, Aa^Fma, Aa^Fma, Aa, Aa^Fma, Ai, Ai, Ai, Aa^Fma, Aa^Fma, Aa^Fma, Aa^Fma, Aa^Fma, Aa^Fma, Aa^Fma
Aa^Fma, Aa^Fma, Aa^Fma, Aa, Aa, Aa^Fma, Aa^Fma, Aa^Fma, Gs, Gs, Aa^Fma, Aa^Fma, Aa^Fma, Aa^Fma, Aa^Fma, Aa^Fma, Aa^Fma, Aa^Fma, Aa^Fma, Aa^Fma, Aa^Fma, Aa, Aa^Fma, Aa^Fma, Aa, Aa, Aa, Aa^Fma, Aa, Aa^Fma, Aa^Fma, Aa^Fma, Aa^Fma, Ai, Wwr^Bw\, Ai, Aa, Aa^Fma, Aa^Fma, Aa^Fma, Aa^Fma, Aa^Fma, Aa^Fma
Aa^Fma, Gs, Gs, Aa^Fma, Aa^Fma, Aa^Fma, Aa^Fma, Aa^Fma, Gs, Gs, Aa^Fma, Aa^Fma, Aa^Fma, Aa^Fma, Aa^Fma, Aa^Fma, Aa^Fma, Aa^Fma, Aa^Fma, Aa^Fma, Aa^Fma, Aa^Fma, Aa, Aa, Aa^Fma, Aa^Fma, Aa, Aa^Fma, Aa^Fma, Aa, Aa^Fma, Aa^Fma, Aa, Ai^Bw/, Ww, Ai^Bw/, Gs, Gs, Gs, Aa^Fma, Aa^Fma, Aa^Fma, Aa^Fma
Aa^Fma, Gs, Gs, Aa^Fma, Aa^Fma, Gs, Gs, Aa^Fma, Aa^Fma, Aa^Fma, Aa^Fma, Aa^Fma, Gs, Aa^Fma, Aa^Fma, Aa^Fma, Aa^Fma, Aa^Fma, Ha, Aa, Aa, Aa, Aa^Fma, Aa^Fma, Aa, Aa, Aa^Fma, Aa^Fma, Aa^Fma, Aa, Aa, Aa^Fma, Aa^Fma, Ai, Ww, Ai, Gs, Aa^Fma, Aa^Fma, Gg^Fet, Aa^Fma, Aa^Fma, Aa^Fma
Aa^Fma, Aa^Fma, Aa^Fma, Gs, Aa^Fma, Aa^Fma, Aa^Fma, Aa^Fma, Gs, Gs, Gs, Gs, Aa^Fma, Aa^Fma, Aa^Fma, Aa^Fma, Ha, Ha, Ha, Ha, Aa, Aa^Fma, Aa^Fma, Aa, Aa^Fma, Aa^Fma, Aa^Fma, Aa^Fma, Aa, Aa^Fma, Aa^Fma, Aa^Fma, Aa^Fma, Ai, Ww, Ai, Gs, Aa^Fma, Aa^Fma, Aa^Fma, Aa^Fma, Aa^Fma, Aa^Fma
Aa^Fma, Aa^Fma, Aa^Fma, Aa^Fma, Aa^Fma, Aa^Fma, Aa^Fma, Aa^Fma, Gs, Gs, Gs, Aa^Fma, Aa^Fma, Aa^Fma, Aa^Fma, Aa^Fma, Aa^Fma, Ha, Ha, Aa, Aa^Fma, Aa, Aa, Aa^Fma, Aa^Fma, Aa^Fma, Aa^Fma, Aa^Fma, Aa, Aa, Aa^Fma, Aa^Fma, Ai, Ai, Wwr, Ai, Aa^Fma, Aa^Fma, Aa^Fma, Aa^Fma, Aa^Fma, Aa^Fma, Aa^Fma
Aa^Fma, Gs, Aa^Fma, Aa^Fma, Gs, Gs, Gs, Gs, Gg^Fet, Gs, Gs, Aa^Fma, Aa^Fma, Aa^Fma, Gs, Aa^Fma, Aa^Fma, Aa^Fma, Aa^Fma, Aa^Fma, Aa^Fma, Aa, Aa, Aa, Aa^Fma, Aa^Fma, Aa^Fma, Aa^Fma, Aa, Aa, Ai, Ai, Ww, Ai, Ai, Ai, Aa^Fma, Aa^Fma, Aa^Fma, Aa^Fma, Aa^Fma, Aa^Fma, Aa^Fma
Aa^Fma, Gs, Gs, Aa^Fma, Gs, Gs, Gs, Gs, Gs, Gs, Gs, Aa^Fma, Aa^Fma, Gs, Aa^Fma, Aa^Fma, Aa^Fma, Aa^Fma, Aa^Fma, Aa^Fma, Aa, Aa^Fma, Aa, Aa, Aa, Aa^Fma, Aa, Aa, Ai, Ai, Ww, Ww, Ai, Ai, Ai, Ai, Ai, Aa^Fma, Gs, Aa^Fma, Aa^Fma, Aa^Fma, Aa^Fma
Aa^Fma, Aa^Fma, Gs, Aa^Fma, Gs, Gs, Aa^Fma, Aa^Fma, Aa^Fma, Gs, Aa^Fma, Aa^Fma, Aa^Fma, Gs, Aa^Fma, Aa^Fma, Aa^Fma, Gs, Aa^Fma, Aa, Aa^Fma, Aa, Aa^Fma, Aa, Aa, Aa^Fma, Aa, Aa, Ai, Ww, Ai, Ai, Aa^Fma, Ai, Wwr, Ai, Ai, Gs, Gs, Aa^Fma, Aa^Fma, Aa^Fma, Aa^Fma
Aa^Fma, Aa^Fma, Gs, Gs, Aa^Fma, Gs, Gs, Aa^Fma, Aa^Fma, Aa^Fma, Aa, Aa, Aa^Fma, Aa^Fma, Aa^Fma, Aa^Fma, Aa^Fma, Aa^Fma, Aa^Fma, Aa^Fma, Aa^Fma, Aa^Fma, Aa^Fma, Aa, Aa, Aa, Aa, Aa^Fma, Ai, Wwr, Ai, Gs, Gs, Ai, Ai, Ww, Ww, Ai, Ai, Aa^Fma, Aa^Fma, Aa^Fma, Aa^Fma
Aa^Fma, Aa^Fma, Gs, Gs, Gs, Aa^Fma, Aa^Fma, Aa^Fma, Aa, Aa^Fma, Aa, Aa^Fma, Aa^Fma, Aa^Fma, Aa, Aa, Aa, Aa, Aa, Aa, Aa, Aa^Fma, Aa^Fma, Aa, Aa^Fma, Aa^Fma, Aa^Fma, Aa^Fma, Ai, Ai, Ai, Aa^Fma, Aa^Fma, Aa^Fma, Aa^Fma, Wwr, Ai, Ai, Wwr, Ai, Aa^Fma, Aa^Fma, Aa^Fma
Aa^Fma, Aa^Fma, Gs, Gs, Aa^Fma, Aa^Fma, Aa^Fma, Aa, Aa^Fma, Aa^Fma, Aa, Aa^Fma, Aa, Aa, Aa^Fma, Aa^Fma, Aa^Fma, Aa^Fma, Aa^Fma, Aa^Fma, Aa^Fma, Aa, Aa^Fma, Aa^Fma, Aa^Fma, Aa, Ai^Bw\, Ai, Wwr, Wwr, Aa^Fma, Aa^Fma, Ha, Aa^Fma, Aa, Ai, Ai, Ww, Ww, Ai, Aa^Fma, Aa^Fma, Aa^Fma
Aa^Fma, Aa^Fma, Gs, Gs, Aa^Fma, Aa^Fma, Aa^Fma, Aa, Aa, Aa, Aa^Fma, Aa^Fma, Aa^Fma, Aa^Fma, Gs^Fdw, Gs^Fdw, Aa^Fma, Gs^Fdw, Aa^Fma, Aa^Fma, Aa^Fma, Aa^Fma, Aa^Fma, Aa^Fma, Ai, Ai, Ai, Ww^Bw\, Ai^Bw\, Ai, Aa, Aa, Aa^Fma, Aa^Fma, Aa^Fma, Aa, Aa^Fma, Ai, Ai, Ai, Ai, Aa^Fma, Aa^Fma
Aa^Fma, Gs, Gg^Fet, Gs, Gs, Gs, Gs, Aa^Fma, Aa^Fma, Aa^Fma, Aa^Fma, Aa^Fma, Aa^Fma, Gs^Fdw, Aa^Fma, Aa^Fma, Aa^Fma, Aa^Fma, Aa, Aa^Fma, Aa, Aa, Aa, Aa, Wwr, Ai, Wwr, Ww, Aa^Fma, Aa, Aa, Aa, Aa, Aa^Fma, Aa^Fma, Aa^Fma, Aa^Fma, Ai, Ai, Ai, Ai, Aa^Fma, Aa^Fma
Aa^Fma, Gs, Gs, Gs, Gs, Aa^Fma, Aa^Fma, Aa^Fma, Aa^Fma, Aa^Fma, Aa^Fma, Gs, Aa^Fma, Aa^Fma, Gg^Fet, Aa, Aa, Aa, Aa^Fma, Aa, Aa^Fma, Aa^Fma, Ai, Ai, Ww, Ai, Gs, Gg^Fet, Gs, Aa^Fma, Aa^Fma, Aa, Aa, Aa, Aa, Aa^Fma, Ai, Ai, Ai, Wwr, Ai, Aa^Fma, Aa^Fma
Aa^Fma, Aa^Fma, Aa^Fma, Aa^Fma, Gs, Aa^Fma, Aa^Fma, Aa, Aa^Fma, Aa^Fma, Aa^Fma, Aa^Fma, Gs, Gs, Aa^Fma, Aa, Aa, Aa^Fma, Aa, Aa, Aa, Aa, Ai, Wwr, Ai, Ai, Aa^Fma, Gs, Aa^Fma, Aa^Fma, Aa^Fma, Aa^Fma, Aa^Fma, Aa, Ai^Bw\, Ai, Ww, Ai, Wwr, Ww, Ww, Aa^Fma, Aa^Fma
Aa^Fma, Aa^Fma, Gs, Gs, Aa^Fma, Aa^Fma, Aa^Fma, Aa, Gs, Gs, Gs, Aa^Fma, Gs, Gs, Aa^Fma, Aa^Fma, Aa, Aa, Aa^Fma, Aa^Fma, Aa^Fma, Aa^Fma, Ai, Ai, Ai, Aa^Fma, Aa^Fma, Aa^Fma, Aa, Aa, Aa, Aa^Fma, Aa^Fma, Aa^Fma, Ai, Ai^Bw\, Ai^Bw\, Wwr, Aa^Fma, Ai, Ww, Ai, Aa^Fma
Aa^Fma, Aa^Fma, Gs, Gs, Gs, Aa^Fma, Aa^Fma, Gs, Gg^Fet, Gg^Fet, Gs, Aa^Fma, Gs, Aa^Fma, Aa^Fma, Aa^Fma, Aa^Fma, Aa^Fma, Aa^Fma, Aa^Fpa, Aa^Fma, Ai, Ww, Wwr, Ai, Aa^Fma, Aa^Fma, Aa^Fma, Aa, Aa, Aa^Fma, Aa^Fma, Aa^Fma, Aa^Fma, Ai, Ww, Ai, Aa, Aa^Vha, Ai, Ww, Ai, Aa^Fma
Aa^Fma, Gs, Aa^Fma, Gs, Gs, Gs, Aa^Fma, Gs, Gs, Gs, Aa^Fma, Aa^Fma, Gs, Aa^Fma, Aa^Fma, Gs^Fdw, Aa^Fma, Aa^Fma, Aa^Fma, Aa^Fma, Aa^Fma, Ai, Wwr, Ai, Ai, Aa^Fma, Aa^Fma, Aa, Aa^Fma, Aa, Aa^Fma, Aa^Fma, Aa^Fma, Aa^Fma, Ai, Ww, Ai, Aa^Fma, Ww, Ai, Ww, Ai, Aa^Fma
Aa^Fma, Aa^Fma, Gs, Gs, Gs, Aa^Fma, Aa^Fma, Aa, Aa^Fma, Aa, Gg^Fet, Gs, Gs, Aa^Fma, Gs^Fdw, Gs^Fdw, Ha, Ha, Aa^Fma, Aa^Fma, Aa^Fma, Ai, Ww, Ai, Aa, Aa^Fma, Aa^Fma, Aa^Fma, Aa^Fma, Aa^Fma, Aa^Fma, Aa^Fma, Aa^Fma, Aa^Fma, Ai, Ww, Ai, Ai, Gs, Ww, Ai, Ai, Aa^Fma
Aa^Fma, Aa^Fma, Aa^Fma, Gs, Gs, Gs, Gs, Aa^Fma, Gs, Aa^Fma, Aa^Fma, Aa^Fma, Aa^Fma, Gs, Gs^Fdw, Aa^Fma, Aa, Ha, Ha, Ha, Aa, Ai, Ww, Ai, Aa^Fma, Aa^Fma, Aa, Aa^Fma, Aa^Fma, Aa^Fma, Aa^Fma, Aa^Fma, Aa^Fma, Aa^Fma, Aa^Fma, Ai, Ai, Ai, Aa^Fma, Ai, Wwr, Ai, Aa^Fma
Aa^Fma, Gs, Aa^Fma, Aa^Fma, Aa^Fma, Aa^Fma, Aa^Fma, Aa^Fma, Aa^Fma, Gs, Gs, Gs^Fdw, Aa^Fma, Aa^Fma, Gs^Fdw, Aa^Fma, Aa, Aa^Fma, Aa^Fma, Aa^Fma, Aa^Fma, Ww, Ww, Ai, Aa, Aa, Aa^Fma, Aa^Fma, Aa^Fma, Aa^Fma, Aa^Fma, Aa^Fma, Aa, Aa^Fma, Aa^Fma, Aa^Fma, Aa^Fma, Aa^Fma, Aa^Fma, Ai, Wwr, Ai, Ww
Aa^Fma, Aa^Fma, Aa^Fma, Aa^Fma, Aa^Fma, Aa^Fma, Aa^Fma, Aa^Fma, Aa, Aa^Fma, Gg^Fet, Gs^Fdw, Gs^Fdw, Gs^Fdw, Aa, Aa^Fma, Aa, Aa^Fma, Aa, Aa, Ai, Ai, Ai, Ai, Aa, Aa^Fma, Aa, Aa, Aa, Aa^Fma, Aa, Aa, Aa^Fma, Aa, Aa^Fma, Gs^Fdw, Aa^Fma, Aa^Fma, Aa^Fma, Ai, Ai, Ww, Ww
Aa^Fma, Aa^Fma, Aa^Fma, Aa^Fma, Aa, Aa, Aa^Fma, Aa, Aa^Fma, Aa, Aa^Fma, Gs^Fdw, Gs^Fdw, Aa^Fma, Aa, Aa, Aa^Fma, Aa, Ai, Ai, Ww, Wwr, Ai, Ai, Aa, Aa, Aa^Fma, Aa, Aa, Aa, Aa, Aa^Fma, Aa^Fma, Aa^Fma, Aa^Fma, Gs^Fdw, Gs^Fdw, Aa^Fma, Aa^Fma, Aa^Fma, Aa^Fma, Ai, Gs^Fdw
Aa^Fma, Aa^Fma, Aa, Aa^Fma, Aa, Aa^Fma, Aa^Fma, Aa^Fma, Aa, Aa^Fma, Ha, Ha, Ha, Aa, Aa, Aa, Aa, Ai, Ai, Wwr, Ai, Ai, Ai, Aa, Aa^Fma, Aa^Fma, Aa^Fma, Aa^Fma, Aa^Fma, Aa^Fma, Aa^Fma, Aa, Aa^Fma, Aa^Fma, Aa^Fma, Gs^Fdw, Gs^Fdw, Aa, Gs^Fdw, Gs^Fdw, Gs^Fdw, Gs^Fdw, Gs^Fdw
Ww, Ai, Ai, Ai, Ai, Ai, Ai, Ai, Ai, Aa, Ai, Ha, Ai, Aa^Fma, Ai, Ai, Ww, Ai, Wwr, Ww, Aa, Ai, Aa, Aa, Aa^Fma, Aa^Fma, Aa^Fma, Aa, Aa^Fma, Aa^Fma, Aa, Aa, Aa^Fma, Aa^Fma, Aa^Fma, Gs^Fdw, Aa, Aa, Gs^Fdw, Gg^Fet, Aa, Gs^Fdw, Gs^Fdw
Ww, Ww, Wwr, Wwr, Ai, Ai, Ww, Ai, Wwr, Ww, Ai, Ai, Ai, Ai, Ww, Ww, Ai, Ai, Ai, Ai, Aa, Aa, Aa, Aa, Aa^Fma, Aa^Fma, Gs, Aa, Aa, Aa^Fma, Aa^Fma, Aa, Aa^Fma, Aa^Fma, Gs^Fdw, Gs^Fdw, Aa, Aa, Gs^Fdw, Aa, Ai, Gs^Fdw, Gs^Fdw
Ww, Ww, Ai, Ai, Ai, Ai, Ai, Ww, Ai, Ai, Ai, Ai, Wwr, Ww, Ai, Ai, Ai, Ai, Aa^Fma, Aa, Ha, Ha, Ha, Aa, Aa^Fma, Aa^Fma, Gs, Aa^Fma, Aa, Aa^Fma, Aa^Fma, Aa, Aa^Fma, Aa, Aa, Aa, Aa, Aa, Wwr, Ai, Ha^Kov, Ai, Ww
Aa^Fma, Aa^Fma, Aa^Fma, Aa^Fma, Aa^Fma, Aa^Fma, Aa^Fma, Ai, Aa^Fma, Ai, Aa^Fma, Ai, Aa^Fma, Ai, Aa, Aa, Aa, Aa^Fma, Aa^Fma, Aa, Aa, Ha, Aa, Aa, Aa^Fma, Aa^Fma, Aa^Fma, Aa^Fma, Aa^Fma, Aa^Fma, Aa^Fma, Aa, Aa, Aa, Aa, Aa, Ai, Wwr, Wwr, Ha^Kov, Gs^Fdw, Ha^Kov, Gs^Fdw
Aa^Fma, Aa^Fma, Aa^Fma, Aa^Fma, Aa^Fma, Aa^Fma, Aa^Fma, Aa^Fma, Aa^Fma, Aa^Fma, Aa^Fma, Aa^Fma, Aa^Fma, Aa, Aa, Aa, Aa, Aa^Fma, Aa^Fma, Aa, Aa, Aa, Aa, Aa^Fma, Aa^Fma, Aa^Fma, Gs, Aa^Fma, Aa^Fma, Aa^Fma, Aa^Fma, Aa, Gs^Fdw, Aa, Gs^Fdw, Ai, Ai, Ai, Gs^Fdw, Gs^Fdw, Gs^Fdw, 2 Gg^Fet, Gs^Fdw
Aa^Fma, Aa^Fma, Aa^Fma, Aa^Fma, Aa^Fma, Aa^Fma, Aa^Fma, Aa^Fma, Aa^Fma, Aa^Fma, Aa^Fma, Aa^Fma, Aa^Fma, Aa^Fma, Aa^Fma, Aa^Fma, Aa^Fma, Aa^Fma, Aa^Fma, Aa^Fma, Aa^Fma, Aa^Fma, Aa^Fma, Aa^Fma, Aa^Fma, Aa^Fma, Aa^Fma, Aa^Fma, Aa^Fma, Aa^Fma, Aa^Fma, Gs^Fdw, Gs^Fdw, Gs^Fdw, Gs^Fdw, Wwr, Gs, Wwr, Gs^Fdw, Gs^Fdw, Gs^Fdw, Gs^Fdw, Gs^Fdw
