Re, Re, Re, Re, Re, Re, Re, Re, Re^Vct, Re, Re, Re, Re, Re, Re, Re, Re, Re, Re, Re, Mm, Mm, Mm, Mm, Mm, Mm, Mm, Gg, Mm, Mm, Mm, Mm
Re, Re, Gs^Fdw, Gs^Fdw, Gs^Fdw, Re, Re, Re, Re, Re, Re, Re, Re, Re, Re, Re, Re, Re, Re^Vct, Re, Mm, Mm, Mm, Mm, Mm, Mm, Mm, Mm, Mm, Mm, Mm, Mm
Ai, Re, Gs^Fdw, Gs^Fdw, Gs^Fdw, Re, Re, Re, Ce, Re, Ce, Re, Ce, Re, Re, Re, Re, Re, Gs^Fdw, Re, Re, Mm, Mm, Mm, Mm, Mm, Mm, Mm^Vhh, Xu, Mm, Mm^Vhh, Mm
Wwr, Ai, Ai, Gs^Fdw, Re^Vct, Re, Re, Re, Ce, Ce, 1 Ke, Ce, Ce, Re, Re, Re, Re, Gs^Fdw, Gs^Fdw, Gs^Fdw, Re, Re, Re, Mm^Vc, Mm, Mm^Vhh, Cud, Xu, 3 Kud, Xu, Xu, Mm
Ai, Wwr, Ai, Ai, Ai, Re, Re, Re, Ce, Ce, Ce, Ce, Ce, Re, Re, Re, Re, Gs^Fdw, Gs^Fdw, Gs^Fdw, Re, Re, Re, Aa, Aa, Mm, Mm, Cud, Cud, Xu, Cud, Mm
Re, Ai, Ai, Ai, Wwr, Ai, Ai, Re, Re, Re, Re, Re, Re, Re, Re, Re, Re, Re, Aa, Aa, Aa, Re, Re, Aa, Aa, Aa, Aa, Mm, Mm, Cud, Mm^Vhh, Mm
Re, Re, Re, Ai, Wwr, Wwr, Ai, Ai, Ai, Re, Re, Re^Vct, Re, Re, Re, Re^Vct, Re, Aa, Aa, Aa, Aa, Aa, Ha, Ha, Ha, Aa, Aa, Aa, Re, Mm, Mm, Mm
Re, Re, Re, Re, Aa, Ai, Ai, Ai, Ai, Ai, Ai, Re, Aa, Aa, Aa, Re, Re, Aa, Aa, Aa, Aa, Ha, Ha, Ha, Ha, Aa, Aa, Re, Re, Re, Re, Mm
Re, Re, Re, Re, Aa, Aa, Ai, Wwr, Wwr, Ai, Ai, Aa, Aa, Aa, Aa, Aa, Re, Aa, Aa, Aa, Aa, Aa, Re, Ha, Aa, Aa, Aa, Aa, Re^Vct, Re, Re, Re
Re, Re, Re, Re^Vct, Ai, Wwr, Wwr, Ai, Ai, Ai, Re, Aa, Aa, Aa, Aa^Vca, Aa, Re, Re, Re, Aa, Re, Re, Re, Aa, Aa, Aa, Aa, Aa, Aa, Aa, Aa, Re
Re, Re, Ai, Ai, Wwr, Wwr, Ai, Ai, Aa, Re, Re, Aa, Aa, Aa, Aa, Aa, Re, Re, Re, Re, Re, Re^Vct, Re, Aa, Aa, Aa, Aa, Aa, Aa, Aa, Aa, Aa
Ai, Ai, Wwr, Ai, Ai, Ai, Aa, Aa, Re, Re, Re, Re, Re, Aa, Re, Re, Re, Re, Re, Re, Re, Re, Re, Re, Re, Aa, Re, Aa, Aa, Aa, Aa^Vca, Aa
Wwr, Wwr, Ai, Ai, Aa, Aa, Aa, Re, Re, Dd^Vdt, Re, Re, Re, Re, Re, Re, Re, Re, Ha, Re, Re, Re, Re, Gs^Fdw, Gs^Fdw, Re, Re, Aa, Aa, Aa, Aa, Aa
Ai, Ai, Aa, Aa, Aa, Aa, Aa, Re, Re, Re, Re, Re, Hh, Re, Re^Vct, Re, Dd^Vdt, Re, Ha, Ha, Re, Re, Gs^Fdw, Gs^Fdw, Re, Re, Re^Vct, Re, Re, Aa, Re, Re
Gg, Gg, Aa, Aa, Aa, Aa, Ha, Re, Re, Re, Hh, Hh, Hh, Hh, Hh, Re, Re, Re, Aa^Vca, Ha, Aa, Re, Re, Gs^Fdw, Re, Re, Re, Re, Re, Re, Re, Re
Aa, Aa, Aa, Aa, Aa, Ha, Ha, Re, Re, Re, Re, Hh, Hh, Hh, Re, Re, Re, Aa, Aa, Ha, Ha, Aa, Re, Re, Aa, Re, Re, Re, Re, Re, Re, Re
Aa, Aa^Vca, Aa, Aa, Aa, Ha, Re, Re, Re, Dd^Vdt, Re, Re, Re, Re, Ds^Dr, Re, Re, Aa, Aa, Ha, Aa, Aa, Aa, Aa, Aa, Aa, Aa, Re, Re, Re, Re, Re
Aa, Aa, Aa, Aa, Aa, Re, Re, Re, Re, Re, Re, Re, Ds^Dr, Ds^Dr, Ql^Bs|, Ds^Dr, Ds^Dr, Aa, Aa, Aa, Aa, Aa, Aa, Aa, Aa, Aa, Aa, Re, Re, Re, Re, Re
Ss, Aa, Aa, Aa, Re, Re, Gll^Ftr, Gll^Ftr, Gll^Ftr, Re, Ds^Dr, Ds^Dr, Ql, Ql, Ce, Ql, Ql, Ds^Dr, Ds^Dr, Aa, Ss, Ss, Aa, Aa, Aa, Aa, Aa, Re, Re, Re, Re^Vct, Re
Ss, Ss, Aa, Aa, Aa, Re, Gll^Ftr, Gll^Ftr, Gll^Ftr, Ds^Dr, Ql^Bs\, Ql, Ce, Ce, Chr, Ce, Ce, Ql, Ql^Bs/, Ds^Dr, Ss, Ss, Aa, Aa, Dd^Vdt, Aa, Aa, Re, Re, Re, Re, Re
Ss, Aa, Aa, Aa, Aa, Aa, Ss, Gll^Ftr, Ss, Ds^Dr, Ql, Ce, Ch, Chr, Ch, Chr, Ch, Ce, Ql, Ds^Dr, Ds^Dr, Ss, Aa, Aa, Aa, Aa, Aa^Dr, Re, Re, Re, Dd^Vdt, Re
Ss, Aa, Aa, Aa^Vca, Aa, Aa, Ss, Ss, Ss, Ds^Dr, Ql, Ce, Ch, Ch, 2 Kud, Ch, Ch, Ce, Ql, Ql, Ql, Ds^Dr, Ds, Aa^Dr, Ds, Ds, Ql, Gs, Gs, Gg^Dr, Gs, Re
Ss, Aa, Aa, Aa, Aa, Aa, Ss, Ss, Dd^Vdt, Ds^Dr, Ql, Ce, Chr, Ch, Ch, Chr, Chr, Ce, Ql, Ds^Dr, Ss, Ql, Ql, Ds, Ql, Ql, Gs, Ql, Ql, Ql, Ql, Gg^Dr
Ss, Ss, Ss, Aa, Ss^Vhs, Ss, Ss, Ss, Ss, Ds^Dr, Ql^Bs/, Ce, Ce, Ch, Ch, Chr, Ce, Ce, Ql^Bs\, Ds^Dr, Dd^Vdt, Ss, Gg^Dr, Ql, Gg^Efm, Gg^Dr, Ss, Gg^Dr, Gs, Gg^Efm, Gg^Dr, Ql
Ss, Ss, Gll^Ftr, Gll^Ftr, Gll^Ftr, Ss, Ss, Ss, Ss, Ds^Dr, Ds^Dr, Ql, Ql, Ce, Ce, Ce, Ql, Ql, Ds^Dr, Ds^Dr, Ss, Ss, Ss, Gs, Ss, Ss, Ss, Ss, Ss, Ss, Gs, Ql
Ss, Ss, Gll^Ftr, Gll^Ftr, Gll^Ftr, Ss, Ss^Vhs, Ss, Ss, Ss, Ss, Ds^Dr, Ds^Dr, Ql, Ql, Ql, Ds^Dr, Ds^Dr, Ss, Ss, Ss, Ss, Ss, Ss, Ss, Ss, Ss, Ss^Vhs, Ss, Ss, Gg^Dr, Ql
Ss, Ss, Ss, Gll^Ftr, Ss, Ss, Ss, Ss, Ss, Ss, Ss, Ss, Ss, Ds^Dr, Ds^Dr, Ds^Dr, Ss, Ss, Ss, Ss, Ss, Ss, Ss, Ss, Ss, Ss, Ss, Ss, Ss, Ss, Gs, Ql
