Re, Re, Re, Re, Re, Re, Re, Re, Re, Re, Re, Re, Re, Re, Re, Re, Re, Re, Re, Re, Re
Re, Re, Re, Re, Re, Re, Re, Re, Re, Re, Re, Re, Re, Re, Re, Re, Re, Re, Re, Re, Re
Re, Re, Re, Re, Re, Re, Re, Re, Re, Re, Re, Re, Re, Re, Re, Re, Re, Re, Re, Re, Re
Re, Re, Re, Re, Re, Re, Re, Re, Re, Re, 1 Re, Re, Re, Re, Re, Re, Re, Re, Re, Re, Re
Re, Re, Re, Re, Re, Re, 5 Re, 3 Re, Re^Bw/, Re, Re^Bw|, Re, Re^Bw\, 2 Re, 4 Re, Re, Re, Re, Re, Re, Re
Re, Re, Re, Re, Re, Re, Re^Bw/, Re^Bw/, Re, Re, Re^Bw|, Re, Re, Re^Bw\, Re^Bw\, 6 Re, Re, Re, Re, Re, Re
Re, Re, Re, Re, Re, Re^Bw/, Re, Re, Re, Re, Re^Bw|, Re, Re, Re, Re, Re^Bw\, Re, Re, Re, Re, Re
Re, Re, Re, Re, Re, Re, Re, Re, Re, Re, Re, Re, Re, Re, Re, Re, Re, Re, Re, Re, Re
Re, Re, Re, Re, Re, Re, Re, Re, Re, Re, Re^Vct, 7 Re^Vct, Re^Vct, Re, Re, Re, Re, Re, Re, Re, Re
Re, Re, Re, Re, Re, Re, Re, Re, Re, Re, Re^Vct, Ur, Re^Vct, Re, Re, Re, Re, Re, Re, Re, Re
Re, Re, Re, Re, Re, Re, Re, Re, Re, Re, Re, Re^Vct, Re, Re, Re, Re, Re, Re, Re, Re, Re
Re, Re, Re, Re, Re, Re, Re, Re, Re, Re, Re, Re, Re, Re, Re, Re, Re, Re, Re, Re, Re
Re, Re, Re, Re, Re, Re, Re, Re, Re, Re, Re, Re, Re, Re, Re, Re, Re, Re, Re, Re, Re
