Aa, Aa, Aa, Aa, Aa, Aa, Aa, Aa, Aa, Aa, Aa, Aa, Aa, Aa, Aa, Aa, Aa, Aa, Aa, Aa, Rd, Rd, Rd, Aa, Aa, Aa, Aa, Aa, Aa, Aa, Aa, Aa, Aa, Aa, Aa, Aa, Aa, Aa, Aa, Aa, Aa, Aa, Aa, Aa, Aa, Aa, Aa
Aa, Aa, Aa, Aa, Aa, Aa, Aa, Aa, Aa^Fma, Aa, Aa, Aa, Aa, Aa, Aa, Aa, Aa, Aa, Aa, Aa, Aa, Rd, Aa, Aa, Aa, Aa, Aa, Aa, Aa, Aa, Aa, Aa, Aa, Aa, Aa, Aa, Aa, Aa, Aa, Aa, Aa, Aa, Aa, Aa, Aa, Aa, Aa
Aa, Aa, Aa, Aa, Aa, Aa, Aa, Aa, Aa^Via, Aa^Fma, Aa, Aa, Aa, Aa, Aa, Aa, Aa^Fma, Aa, Aa, Aa, Aa, Rd, Aa, Aa, Cea, Cea, 1 Kea, Cea, Cea, Aa, Aa, Aa, Aa, Aa, Aa^Fma, Aa, Aa^Fma, Aa^Fma, Aa^Fma, Aa, Aa, Aa, Aa, Aa, Aa, Aa, Aa
Aa, Aa, Aa, Aa, Aa, Aa, Aa, Aa, Aa, Aa^Fma, Aa, Aa, Aa, Aa, Aa^Fma, Aa^Fma, Aa^Fma, Aa, Aa, Aa, Aa, Rd, Aa, Aa, Cea, Cea, Cea, Cea, Cea, Aa, Aa, Aa, Aa, Aa, Aa^Fma, Aa, Aa^Fma, Aa, Aa, Aa, Aa, Aa, Aa, Aa, Aa, Aa, Aa
Aa, Aa, Aa, Aa, Aa, Aa, Aa, Aa, Aa, Aa, Aa, Aa, Aa, Aa, Aa, Aa^Fma, Aa, Aa, Aa, Aa, Aa, Rd, Aa, Aa, Aa, Cea, Aa, Cea, Aa, Aa, Aa, Aa, Aa, Aa, Aa, Aa^Fma, Aa, Aa, Aa, Aa, Aa, Aa, Aa, Aa^Via, Aa, Aa, Aa
Aa, Aa, Aa, Aa, Aa, Aa^Fma, Aa^Fma, Aa, Aa, Aa, Aa, Aa, Aa, Aa, Aa, Aa, Aa, Aa, Aa, Aa, Rd, Rd, Aa, Aa, Aa, Aa, Aa, Aa, Aa, Aa, Aa, Aa, Aa, Aa, Aa, Aa, Aa, Aa, Aa, Aa, Aa, Aa, Aa, Aa, Aa, Aa, Aa
Aa, Aa, Aa, Aa, Aa^Fma, Aa^Fma, Aa^Via, Aa, Aa, Aa, Aa, Aa, Aa, Aa, Aa, Aa, Aa, Aa, Aa, Aa, Rd, Aa, Aa, Aa, Aa, Aa, Aa, Aa, Aa, Aa, Aa, Aa, Aa, Aa, Aa, Aa, Aa, Aa, Aa, Aa, Aa, Aa, Aa, Aa, Aa, Aa, Aa
Aa, Aa, Aa, Aa, Aa^Fma, Aa^Fma, Aa^Fma, Aa^Fma, Aa, Aa, Aa, Aa, Aa, Aa, Aa, Aa, Aa, Aa, Rd, Rd, Aa, Aa, Aa, Aa, Aa, Aa, Aa, Aa, Aa, Aa, Aa^Fma, Aa, Aa^Fma, Aa, Aa, Aa, Aa^Fma, Aa, Aa^Fma, Aa, Aa, Aa, Aa, Aa, Aa, Aa, Aa
Aa, Aa, Aa, Aa, Aa, Aa, Aa, Aa, Aa, Aa, Aa, Aa, Aa, Aa, Aa, Aa, Aa, Rd, Aa, Aa, Aa, Aa, Aa, Aa, Aa, Aa, Aa, Aa, Aa, Aa^Fma, Aa^Fma, Aa^Fma, Aa, Aa, Aa^Via, Aa, Aa, Aa^Fma, Aa, Aa, Aa, Aa, Aa, Aa, Aa, Aa, Aa
Aa, Aa, Aa, Aa, Aa, Aa, Aa, Aa, Aa, Aa, Aa, Aa^Via, Aa, Aa, Aa, Aa, Aa, Rd, Aa, Aa, Aa, Aa, Re^Vct, Aa, Aa, Aa, Aa, Aa, Aa, Aa, Aa, Aa, Aa, Aa, Aa, Aa, Aa, Aa, Aa, Aa, Aa, Aa, Aa, Aa, Aa, Aa, Aa
Aa, Aa, Aa, Aa, Aa, Aa, Aa, Aa^Fma, Aa^Fma, Aa^Fma, Aa, Aa, Aa, Aa, Aa, Aa, Aa, Rd, Aa, Aa, Aa, Aa, Aa, Aa, Aa, Aa, Aa, Aa, Aa, Aa, Aa, Aa, Aa, Aa, Aa, Aa, Aa, Aa, Aa, Aa, Aa, Aa, Aa, Aa, Aa, Aa, Aa
Aa, Aa, Aa, Aa, Aa, Aa^Fma, Aa^Fma, Aa^Fma, Aa, Aa, Aa, Aa, Aa, Aa, Aa, Aa, Rd, Rd, Aa, Aa, Aa, Aa, Aa, Aa, Cea, 8 Kea, Cea, Aa, Aa, Aa, Aa, Aa, Aa, Aa, Aa, Aa, Aa, Aa, Aa, Aa, Aa, Aa, Aa^Via, Aa, Aa, Aa, Aa
Aa, Aa, Aa^Via, Aa, Aa, Aa, Aa, Aa^Fma, Aa, Aa, Aa, Aa, Aa, Aa, Aa, Aa, Rb, Aa, Aa, Aa, Aa, Aa, Aa, Aa, Cea, Aa, Cea, Aa, Aa, Aa, Aa, Aa, Aa, Aa, Aa, Aa, Aa, Aa, Aa, Aa, Aa, Aa, Aa, Aa, Aa, Aa, Rd
Aa, Aa, Aa, Aa, Aa, Aa, Aa, Aa, Aa, Aa, Aa, Aa, Aa, Aa, Aa, Aa, Rb, Aa, Aa, Aa, Aa, Aa, Aa, Aa, Aa, Aa, Aa, Aa, Aa, Aa, Aa, Aa, Aa, Aa, Aa, Aa, Aa, Aa, Aa, Aa, Aa^Fma, Aa, Aa^Fma, Aa, Rd, Rd, Aa
Aa, Aa, Aa, Aa, Aa, Aa, Aa, Aa, Aa, Aa, Aa, Aa, Aa, Aa, Rb, Rb, Aa, Aa, Aa, Aa, Aa, Aa, Aa, Aa, Aa, Aa, Aa, Aa, Re^Vct, Aa, Aa, Aa, Aa, Aa, Aa, Aa, Aa, Aa, Aa, Aa^Fma, Aa^Fma, Aa^Fma, Aa, Aa, Rd, Aa, Aa
Aa, Aa, Aa, Aa, Aa, Aa, Aa, Aa, Aa, Aa, Aa, Aa, Aa, Aa, Rb, Aa, Aa, Aa, Aa^Fma, Aa, Aa, Aa, Aa, Aa, Aa, Aa, Aa, Aa, Aa, Aa, Aa, Aa, Aa, Aa, Aa, Aa^Via, Aa, Aa, Aa, Aa, Aa, Aa, Aa, Aa, Rd, Aa, Aa
Wwr, Aa, Aa, Aa, Aa, Aa, Aa, Aa, Aa, Aa, Aa, Aa, Aa, Rb, Aa, Aa, Aa, Aa, Aa^Fma, Aa, Aa, Aa, Aa, Aa, Aa, Aa, Aa, Aa, Aa, Aa, Aa, Aa, Aa, Aa, Aa, Aa, Aa, Aa, Aa, Aa, Aa, Aa, Rb, Rd, Aa, Aa, Aa
Wwr, Wwr, Wwr, Aa, Aa, Aa, Aa, Aa, Aa, Aa, Aa, Aa, Aa, Rb, Rb, Aa, Aa, Aa, Aa, Aa, Aa, Aa, Aa, Aa, Aa, Aa, Aa, Aa, Aa, Aa, Aa^Fda, Aa, Aa, Aa, Aa, Aa, Aa, Aa, Aa, Aa, Rb, Rb, Aa, Aa, Aa, Aa, Aa
Aa, Wwr, Wwr, Wwr, Wwr, Wwr, Wwr, Aa, Aa, Aa, Aa, Aa, Ai, Ai, Ai, Rb, Rb, Aa, Aa, Aa, Ai, Ai, Aa, Aa, Aa, Aa, Aa, Aa, Aa, Aa, Aa, Aa, Aa, Aa, Aa, Aa, Aa, Aa, Aa, Aa, Rb, Aa, Cea, Cea, Cea, Aa, Aa
Rb, Aa, Aa, Wwr, Wwr, Wwr, Wwr, Wwr, Wwr, Aa, Ai, Ai, Wwr, Wwr, Wwr, Ai, Rb, Rb, Rb, Aa, Aa, Ai, Aa, Aa, Cea, Aa, Ai, Aa, Ai, Aa, Aa, Aa, Aa, Aa, Rb, Rb, Rb, Aa, Rb, Rb, Aa, Aa, Cea, 7 Kea, Cea, Aa, Aa
Aa, Rb, Rb, Aa, Rb, Aa, Aa, Wwr, Wwr, Wwr, Wwf, Wwr, Ai, Ai, Rb, Ww^Bw/, Wwr, Aa, Aa, Rb, Rb, Aa, Cea, Cea, Re^Vi, Cea, Cea, Ai, Aa, Aa, Aa, Aa, Rb, Rb, Aa, Aa, Aa, Rb, Rb, Aa, Aa, Aa, Aa, Cea, Aa, Aa, Rd
Aa, Aa, Aa, Rb, Aa, Rb, Rb, Aa, Aa, Wwr, Ai, Ai, Rb, Rb, Aa, Ai, Ai, Ai, Wwr, Aa, Cea, Cea, Re^Vi, Re^Vi, Re^Vi, Re^Vi, Re^Vi, Cea, Cea, Aa, Rb, Rb, Aa, Aa, Aa, Aa, Aa, Aa, Aa, Rb, Rb, Aa, Aa, Aa, Rd, Rd, Aa
Aa, Aa, Aa, Aa, Aa, Aa, Aa, Rb, Rb, Aa, Aa, Aa, Rb, Rb, Rb, Aa, Aa, Aa, Aa, Wwr, Cea, Cea, Kea, Re^Vi, Re^Vi, Re^Vi, 5 Kea, Cea, Cea, Rb, Aa, Aa, Aa, Aa, Aa, Aa, Aa, Aa, Aa, Aa, Aa, Rb, Rb, Rd, Aa, Aa, Aa
Aa, Aa, Aa, Re^Vct, Aa, Aa, Aa, Aa, Aa, Rb, Rb, Rb, Aa, Aa, Aa, Rb, Rb, Aa^Fda, Aa, Wwr, Cea, Re^Vi, Re^Vi, Cea, 2 Kea, Cea, Re^Vi, Re^Vi, Cea, Aa, Aa, Aa, Aa, Aa, Aa, Aa^Via, Aa, Aa, Aa, Aa, Aa, Aa, Aa, Rd, Rd, Aa, Aa
Aa, Aa, Aa, Aa, Aa, Aa, Aa, Aa, Aa, Aa, Aa, Aa, Aa, Aa^Fda, Aa, Aa, Aa, Rb, Rb, Ww^Bw/, Cea, Re^Vi, 3 Kea, Cea, Cea, Cea, 4 Kea, Re^Vi, Cea, Ai, Aa, Aa, Aa, Aa, Aa, Aa, Aa, Aa, Aa, Aa, Aa, Aa, Aa, Aa, Aa, Rd, Rd
Ha, Aa, Ha, Aa, Cea, Cea, Cea, Aa, Aa, Aa, Aa, Aa, Aa^Voa, Aa, Aa, Aa, Rb, Rb, Aa, Ww^Bw\, Cea, Cea, Re^Vi, Re^Vi, Re^Vi, Re^Vi, Re^Vi, Cea, Cea, Ai, Aa^Fda, Aa, Aa, Aa, Aa, Aa, Aa, Aa, Aa, Aa, Aa, Aa, Aa^Fma, Aa, Aa, Aa, Aa
Ha, Ha, Ha, Cea, 6 Kea, Cea, Cea, Ha, Aa, Aa, Aa, Aa, Aa, Aa, Rb, Rb, Aa, Aa, Aa, Wwr, Aa, Cea, Cea, Re^Vi, Re^Vi, Re^Vi, Cea, Cea, Rb, Aa, Aa, Aa, Aa, Aa, Aa, Aa, Aa, Aa, Aa, Aa, Aa, Aa, Aa^Fma, Aa^Fma, Aa, Aa, Aa
Ha, Ha, Ha, Cea, Cea, Cea, Ha, Ha, Ha, Aa, Aa, Aa, Aa, Aa, Rb, Aa, Aa, Aa, Aa, Wwr, Wwr, Aa, Aa, Cea, Cea, Cea, Aa, Rb, Rb, Rb, Rb, Aa, Aa, Aa, Aa, Aa^Via, Aa, Aa, Aa, Aa, Aa, Aa, Aa, Aa^Fma, Aa, Aa, Aa
Ha, Ha, Ha^Voa, Ha, Ha, Ha, Ha, Ha^Voa, Ha, Ha, Ha, Aa, Rb, Rb, Aa, Aa, Aa, Aa, Aa, Aa, Aa, Wwr, Wwr, Aa, Ai, Aa, Ai, Aa, Aa, Rb, Rb, Aa, Aa, Aa, Aa, Aa, Aa, Aa, Aa, Aa, Aa, Aa, Aa, Aa, Aa, Aa, Aa
Ha, Ha, Ha, Ha, Ha, Ha, Ha, Ha, Ha, Ha, Ha, Rb, Aa, Aa, Aa^Fda, Aa, Aa, Aa, Aa, Aa^Fda, Aa, Aa, Aa, Wwr, Wwr, Ai, Aa, Aa, Aa, Rb, Rb, Aa, Aa, Aa, Aa, Aa, Aa, Aa, Aa, Aa, Aa, Aa, Aa, Aa, Aa^Via, Aa, Aa
Ha, Ha, Ha, Ha, Ha, Ha, Ha, Ha, Ha, Ha, Rb, Rb, Aa, Aa^Fda, Aa, Aa, Aa, Aa, Aa, Aa, Aa, Aa, Aa, Aa, Aa, Wwr, Wwr, Aa, Aa, Rb, Rb, Aa, Aa, Aa, Aa, Aa, Aa, Aa, Aa, Aa, Aa, Aa, Aa, Aa, Aa, Aa, Aa
Ha, Ha, Ha^Fpa, Ha, Ha^Fpa, Ha, Ha, Ha, Rb, Rb, Ha, Ha, Ha^Fpa, Aa, Aa, Aa, Aa, Aa, Aa, Aa, Aa, Aa, Aa^Fda, Aa, Aa, Aa, Aa^Fda, Wwr, Wwr, Rb, Rb, Aa, Aa, Aa, Aa, Aa, Aa, Aa, Aa, Aa, Aa, Aa, Aa, Aa, Aa, Aa, Aa
Ms, Ha, Ms, Ha, Ha, Ha, Ha, Rb, Ha, Ha, Ha^Voa, Ha, Ha, Ha, Ha, Aa, Aa, Aa, Aa, Aa, Aa, Aa, Aa, Aa, Aa, Aa, Aa, Aa, Rb, Ww^Bw|, Wwr, Aa, Aa, Aa, Aa, Aa, Aa, Aa, Aa, Aa, Aa, Aa, Aa, Aa, Aa, Aa, Aa
Ms, Ms, Ms, Ms, Ms, Ms, Ms, Rb, Ms, Ha, Ha, Ha, Ha, Ha, Ha, Ha, Ha, Ha, Ha, Aa, Aa, Aa, Aa, Aa, Aa, Aa, Aa, Aa, Rb, Rb, Rb, Wwr, Wwr, Aa, Aa, Aa, Aa, Aa, Aa, Aa, Aa, Aa, Aa, Aa, Aa, Aa, Aa
Ms, Ms, Ms, Ms^Vhha, Ms, Ms, Ms, Ms, Ms, Ms, Ms, Ms, Ms, Ms, Ms, Ms, Ms, Ha, Ha, Ha^Voa, Ha, Aa, Aa, Aa, Aa, Aa, Aa, Aa, Rb, Rb, Rb, Aa, Aa, Wwr, Aa, Aa, Aa, Aa, Aa, Aa, Aa, Aa, Aa, Aa, Aa, Aa, Aa
Ms, Ms, Ms, Ms, Ms, Ms, Ms, Ms, Ms, Ms, Ms, Ms, Ms, Ms, Ms, Ms, Ms, Ms, Ms, Ha, Ha^Fpa, Ha, Ha, Aa, Aa, Aa, Aa, Aa, Rb, Rb, Rb, Aa, Aa, Wwr, Wwr, Aa, Aa, Aa, Aa, Aa^Via, Aa, Aa, Aa, Aa, Aa, Aa, Aa
Ms, Rd, Rd, Ms, Rd, Rd, Ms, Ms, Ms, Ms, Ms, Ms^Vhha, Ms, Ms, Ms, Ms, Ms, Ms, Ms, Ha, Cea, Ha, Ha, Aa, Aa, Aa, Aa, Aa, Rb, Rb, Rb, Aa, Aa, Aa, Aa, Wwr, Wwr, Aa, Aa, Aa, Aa, Aa, Aa, Aa, Aa, Aa, Aa
Ms, Ms, Ms, Rd, Ms, Ms, Ms, Ms, Ms^Vhha, Ms, Ms, Ms, Ms, Ms, Ms, Ms, Ms, Ms, Ms, Cea, Cea, Cea, Cea, Ha, Ha, Aa, Aa, Aa, Rd, Rb, Rb, Aa, Aa, Aa, Wwr, Wwr, Wwr, Aa, Aa, Aa, Aa, Aa, Aa, Aa^Via, Aa, Aa, Aa
Ms, Ms, Ms, Ms, Ms, Ms, Ms, Ms, Ms, Ms, Ms, Ms, Ms, Ms, Ms, Ms, Ms, Ms, Ms, Cea, Cea, Cea, Cea, Cea, Cea, Ha, Ha, Aa, Rd, Rd, Rd, Aa, Aa, Aa, Wwr, Wwr, Wwr, Aa, Aa, Aa, Aa^Via, Aa, Aa, Aa, Aa, Aa, Aa
Ms, Ms^Vhha, Ms, Rd, Ms, Ms, Ms, Ms, Ms, Ms, Ms, Ms, Ms, Ms, Ms, Ms, Ms, Ms, Ms, Ms, Ms, Cea, Cea, Cea, Cea, Cea, Ha, Ha^Voa, Rd, Rd, Rd, Aa, Aa, Aa, Aa, Wwr, Wwr, Aa, Aa, Aa, Aa, Aa, Aa^Fma, Aa^Fma, Aa, Aa, Aa
Ms, Ms, Ms, Rd, Ms, Ms, Ms, Ms, Ms, Ms, Ms, Ms, Ms, Ms, Ms^Vhha, Ms, Ms, Ms, Ms, Ms, Ms, 9 Kea, Cea, Cea, Cea, Cea, Ha, Ha, Rd, Rd, Rd, Ha, Ha^Voa, Aa, Wwr, Wwr, Wwr, Aa, Aa, Aa, Aa, Aa, Aa, Aa^Fma, Aa, Aa, Aa
Ms, Ms, Ms, Rd, Ms, Ms, Ms, Ms, Ms, Ms, Ms, Ms, Ms, Ms, Ms, Ms, Ms, Ms, Ms, Ms, Ms, Ms, Ms, Cea, Cea, Cea, Ha, Ha, Rd, Rd, Rd, Ha, Ha, Ha, Wwr, Wwr, Wwr, Wwr, Wwr, Aa, Aa, Aa, Aa, Aa, Aa, Aa, Aa
