Aa^Fma, Aa^Fma, Aa^Fma, Aa^Fma, Aa^Fma, Aa^Fma, Aa^Fma, Aa^Fma, Aa^Fma, Aa^Fma, Aa^Fma, Aa^Fma, Aa^Fma, Aa^Fma, Aa^Fma, Aa^Fma, Aa^Fma, Aa^Fma, Aa^Fma, Aa^Fma, Aa^Fma, Aa^Fma, Aa^Fma, Aa^Fma, Aa^Fma, Aa^Fma, Aa^Fma, Aa^Fma, Aa^Fma, Aa^Fma, Aa^Fma, Aa^Fma, Aa^Fma, Aa^Fma, Aa^Fma, Aa^Fma, Aa^Fma, Aa^Fma, Aa^Fma, Aa^Fma, Aa^Fma, Aa^Fma, Aa^Fma, Aa^Fma, Ss, Aa^Fma
Ai, Aa^Fma, Aa^Fma, Aa^Fma, Aa^Fma, Aa^Fma, Aa^Fma, Aa^Fma, Aa^Fma, Aa^Fma, Aa^Fma, Aa^Fma, Aa, Aa^Fma, Aa, Aa^Fma, Aa, Aa^Fma, Aa^Fma, Aa^Fma, Aa^Fma, Aa^Fma, Aa^Fma, Aa^Fma, Aa^Fma, Aa^Fma, Aa^Fma, Aa^Fma, Aa^Feta, Aa^Fma, Aa^Fma, Aa^Fma, Aa^Fma, Aa^Fma, Aa^Vha, Aa^Fma, Aa^Fma, Aa^Fma, Aa^Fma, Aa^Fma, Aa^Fma, Aa^Fma, Aa^Fma, Ss, Chs, Ss
Wwr, Wwr, Chw, Chw, Chw, Aa, Aa, Aa, Aa, Aa, Rb, Aa, Rb, Rb, Rb, Aa, Aa, Aa, Aa^Fma, Aa^Fma, Aa^Fma, Aa^Fma, Aa^Fma, Aa^Fma, Aa^Fma, Aa^Fma, Aa^Fma, Aa^Fma, Aa^Fma, Aa^Fma, Aa^Fma, Aa^Fma, Aa^Fma, Aa^Fma, Aa^Fma, Aa^Fma, Aa^Fma, Aa^Fma, Aa^Feta, Aa^Fma, Aa^Fma, Aa^Fma, Aa, Chs, 3 Khs, Chs
Wwr, Wwr, Chw, 2 Khw, Chr, Aa, Rb, Aa, Aa, Aa, Aa, Aa, Aa, Aa, Aa, Aa, Rb, Aa, Aa, Aa^Feta, Aa^Fma, Aa^Fma, Aa, Aa, Aa, Aa, Rb, Aa, Aa, Aa^Fma, Aa^Fma, Aa^Fma, Aa^Fma, Aa^Fma, Aa^Fma, Aa^Fma, Aa^Fma, Aa^Fma, Aa^Fma, Aa^Fma, Aa, Aa, Rb, Chr, Chs, Chs
Aa^Fma, Ai, Aa, Chr, Aa, Rb, Aa, Aa, Aa^Fma, Aa^Fma, Aa^Fma, Aa^Fma, Aa^Fma, Aa, Aa^Fma, Aa, Aa, Rb, Aa, Aa, Aa^Fma, Aa^Fma, Aa, Rb, Aa, Rb, Aa, Aa, Aa^Fma, Aa^Fma, Aa^Fma, Aa^Fma, Aa^Fma, Aa^Fma, Aa^Fma, Aa^Fma, Aa^Fma, Aa^Fma, Aa^Fma, Aa^Fma, Aa, Rb, Aa, Aa, Ss, Ss
Aa^Fma, Aa^Fma, Aa^Fma, Aa^Fma, Aa^Fma, Aa^Fma, Aa^Fma, Aa^Fma, Aa^Fma, Aa^Fma, Aa^Fma, Aa^Fma, Aa^Fma, Aa^Fma, Aa^Fma, Aa^Fma, Aa^Fma, Aa, Aa, Aa, Aa, Aa^Fma, Aa, Aa, Aa, Aa, Aa, Aa, Aa^Vha, Aa^Fma, Aa^Fma, Aa^Fma, Aa, Rb, Rb, Aa, Aa, Aa^Fma, Aa^Fma, Aa, Rb, Rb, Aa, Aa^Fma, Aa^Fma, Ss
Aa^Fma, Aa^Fma, Aa^Fma, Aa^Fma, Aa^Fma, Aa^Fma, Aa^Fma, Aa^Fma, Aa^Vha, Aa^Fma, Aa^Fma, Aa^Feta, Aa^Fma, Aa^Fma, Aa^Fma, Aa^Fma, Aa^Fma, Aa^Fma, Aa, Aa, Aa, Aa^Fma, Aa, Aa, Aa, Aa, Aa^Fma, Aa^Fma, Aa^Fma, Aa^Fma, Aa^Fma, Aa^Fma, Aa, Aa, Aa, Aa, Aa^Fma, Aa^Fma, Aa^Fma, Aa, Rb, Aa, Aa, Aa^Fma, Aa^Fma, Aa^Fma
Aa^Fma, Aa^Fma, Aa^Feta, Aa^Fma, Aa^Fma, Aa^Fma, Aa^Fma, Aa^Fma, Aa^Fma, Aa^Fma, Aa^Fma, Aa^Fma, Aa^Fma, Aa^Fma, Aa^Fma, Aa^Fma, Aa, Aa, Aa, Aa, Aa, Aa, Aa, Aa, Aa, Aa, Aa, Aa^Fma, Aa^Fma, Aa^Fma, Aa^Fma, Aa^Fma, Aa^Fma, Aa, Aa, Aa, Aa^Fma, Aa^Fma, Aa^Fma, Aa, Aa, Aa, Aa^Fma, Aa^Fma, Aa^Fma, Aa^Fma
Aa^Fma, Aa^Fma, Aa^Fma, Aa^Fma, Aa^Fma, Aa^Fma, Aa^Fma, Aa^Fma, Aa^Fma, Aa^Fma, Aa^Fma, Aa^Fma, Aa^Fda, Aa^Fma, Aa^Fma, Aa^Fma, Aa^Fma, Rb, Rb, Rb, Aa, Aa, Aa, Aa, Aa, Aa, Aa, Aa, Aa, Aa^Fma, Aa^Fma, Aa^Fma, Aa^Feta, Aa^Fma, Aa^Fma, Aa^Fma, Aa^Fma, Aa^Fma, Aa^Fma, Aa^Fma, Aa^Fma, Aa, Aa^Fma, Aa^Fma, Aa^Fma, Aa^Fma
Aa^Fma, Aa^Fma, Aa^Fda, Aa^Fma, Aa^Fda, Aa^Fda, Aa^Fda, Aa^Fda, Aa^Fda, Aa^Fda, Aa^Fda, Aa^Fda, Aa^Fda, Aa^Fda, Aa^Fda, Aa^Fma, Aa^Fma, Aa, Aa, Aa, Aa, Aa, Rb, Aa, Aa, Aa, Aa, Aa, Aa, Aa^Fma, Aa^Fma, Aa^Fma, Aa^Fma, Aa^Fma, Aa^Fma, Aa^Fma, Aa, Aa, Aa, Aa, Aa, Aa^Fma, Aa^Fma, Aa^Fma, Aa^Fma, Aa^Fma
Aa^Fda, Aa^Fma, Aa^Fda, Aa^Fda, Aa^Fda, Aa^Fda, Aa^Fma, Aa^Fma, Aa^Fma, Aa^Fma, Aa^Fma, Aa^Fma, Aa^Fma, Aa^Fma, Aa^Fma, Aa^Fma, Aa^Fma, Aa^Fma, Aa^Fma, Aa^Fma, Aa^Fma, Aa, Aa, Aa, Aa, Aa, Rb, Rb, Aa, Aa, Aa, Aa^Fma, Aa^Fma, Aa^Fma, Aa^Fma, Aa^Fma, Aa, Aa, Rb, Rb, Aa, Aa^Fma, Aa^Fma, Aa^Feta, Aa^Fma, Aa^Fma
Aa^Fda, Aa^Fda, Aa^Fma, Aa^Vha, Aa^Fma, Aa^Fma, Aa^Fma, 5 Aa^Feta, Aa^Fma, Aa^Fma, Aa^Fma, Aa^Fma, Aa^Feta, Aa^Fma, Aa^Fma, Aa^Fma, Aa^Fma, Aa^Fda, Aa^Fda, Aa^Feta, Aa^Fda, Aa^Fma, Aa^Fma, Aa, Aa, Aa, Aa, Rb, Rb, Aa, Aa, Aa, Aa^Fma, Aa^Fma, Aa^Fma, Aa^Fma, Aa, Aa, Aa, Aa, Aa^Fma, Aa^Fma, Aa^Fma, Aa^Fma, Aa^Fma, Aa^Fma
Aa^Feta, Aa^Fda, Aa^Fda, Aa^Fma, Aa^Fda, Aa^Fma, Aa^Fma, Aa^Fma, Aa^Fma, Aa^Fma, Aa^Fma, Aa^Fda, Aa^Fma, Aa^Fma, Aa^Fma, Aa^Fma, Aa^Vha, Aa^Fma, Aa^Fma, Aa^Fda, Aa^Fma, Aa^Fda, Aa^Fda, Aa^Fma, Aa^Fma, Aa, Aa, Aa, Aa, Aa, Aa, Aa, Aa, Aa^Fma, Aa^Fma, Aa^Fma, Aa^Fma, Aa, Aa^Fma, Aa^Fma, Aa^Fma, Aa^Fma, Aa^Fma, Aa^Vha, Aa^Fma, Aa^Fma
Aa^Feta, Aa^Fda, Aa^Feta, Aa^Fda, Aa^Feta, Aa^Fma, Aa^Fma, Aa^Fma, Aa^Fma, Aa^Fma, Aa^Fma, Aa^Fma, Aa^Fma, Aa^Fma, Aa^Fma, Aa^Fda, Aa^Fma, Aa^Fda, Aa^Fma, Aa^Fda, Aa^Fda, Aa^Fda, Aa^Fda, Aa^Fda, Aa^Fda, Aa^Fma, Aa^Fma, Aa, Aa^Fma, Rb, Aa, Aa, Aa, Aa^Fma, Aa^Fma, Aa^Fma, Aa^Fma, Aa^Fma, Aa^Fma, Aa^Fma, Aa^Fma, Aa^Fma, Aa^Fma, Aa^Fma, Aa^Fma, Aa^Fma
Aa^Feta, Aa^Feta, Rb, Aa^Feta, Aa^Feta, Aa^Feta, Aa^Feta, Aa^Fda, Aa^Feta, Aa^Fda, Aa^Feta, Aa^Fma, Aa^Fda, Aa^Fda, Aa^Fda, Aa^Fma, Aa^Fma, Aa^Fma, Aa^Fma, Aa^Fma, Aa^Fda, Aa^Fda, Aa^Fda, Aa^Fda, Aa^Fda, Aa^Fda, Aa^Fda, Aa^Fma, Aa^Fda, Aa^Fda, Rb, Aa, Aa, Aa^Fma, Aa^Fma, Aa^Feta, Aa^Fma, Aa^Fma, Aa^Fma, Aa^Fma, Aa^Fma, Aa^Fma, Aa^Fma, Aa^Fma, Aa^Fma, Aa^Fma
Aa^Fda, Aa^Feta, Aa^Fda, Aa^Feta, Aa^Feta, Rb, Aa^Feta, Aa^Feta, Aa^Feta, Aa^Feta, Aa^Feta, Aa^Feta, Aa^Feta, Aa^Fda, Aa^Feta, Aa^Fda, Aa^Fda, Aa^Fda, Aa^Feta, Aa^Fda, Aa^Fda, Aa^Fda, Aa^Fma, Aa^Fda, Aa^Fda, Aa^Fda, Aa^Feta, Aa^Fma, Aa^Fda, Aa^Fma, Aa, Rb, Aa, Aa^Fma, Aa^Fma, Aa^Fma, Aa^Fma, Aa^Fma, Aa^Fma, Aa^Vha, Aa^Fma, Aa^Fma, Aa^Fma, Aa^Fma, Aa^Fma, Aa^Fma
Aa^Fda, Aa^Fma, Aa^Fma, Aa^Fda, Aa^Feta, Rb, Aa^Feta, Aa^Feta, Aa^Feta, Rb, Rb, Rb, Aa^Feta, Aa^Feta, Rb, Aa^Feta, Rb, Rb, Aa^Feta, Aa^Feta, Aa^Feta, Aa^Fma, Aa^Fma, Aa^Fma, Aa^Fma, Aa^Fda, Aa^Fda, Aa^Fma, Aa^Fma, Aa^Fda, Aa^Fma, Aa, Rb, Aa, Aa^Fma, Aa^Fma, Aa^Fma, Aa^Fma, Aa^Fma, Aa^Fma, Aa^Fma, Aa^Fma, Aa^Fma, Aa^Feta, Aa^Fma, Aa^Fma
Aa^Fda, Aa^Fda, Aa^Fma, Aa^Fma, Aa^Fma, Aa^Fda, Aa^Fma, Aa^Fda, Aa^Fda, Aa^Feta, Aa^Feta, Aa^Feta, Aa^Feta, Rb, Aa^Feta, Aa^Feta, Aa^Feta, Rb, Aa^Feta, Rb, Rb, Aa^Feta, Aa^Feta, Aa^Fma, Aa^Fma, Aa^Fda, Aa^Fda, Aa^Fda, Aa^Fda, Aa^Fda, Aa^Fma, Aa, Rb, Aa, Aa, Aa^Fma, Aa^Fma, Aa^Fma, Aa^Fma, Aa^Fma, Aa^Fma, Aa^Fma, Aa^Fma, Aa^Fma, Aa^Fma, Aa^Fma
Aa^Fda, Aa^Vea, Aa^Fda, Aa^Fma, Aa^Fda, Aa^Fma, Aa^Fda, Aa^Fma, Aa^Fda, Aa^Fda, Aa^Fda, Aa^Fda, Aa^Fda, Aa^Feta, Aa^Fda, Aa^Feta, Aa^Feta, Aa^Feta, Aa^Feta, Aa^Feta, Aa^Feta, Rb, Rb, Aa^Feta, Aa^Feta, Aa^Fma, Aa^Fma, Aa^Fda, Aa^Fda, Aa^Fda, Aa^Fma, Aa, Aa, Aa, Rb, Aa^Fma, Aa^Fma, Aa, Aa, Aa, Rd, Aa, Rd, Aa, Rd, Aa
Aa^Fda, Aa^Fda, Aa^Fda, Aa^Fma, Aa^Fma, Aa^Fma, Aa^Fma, Aa^Fda, Aa^Fda, Aa^Fda, Aa^Fda, Aa^Fda, Aa^Fda, Aa^Fda, Aa^Fda, Aa^Fda, Aa^Fda, Aa^Feta, Aa^Fda, Aa^Feta, Aa^Feta, Aa^Feta, Aa^Feta, Aa^Feta, Ms, Aa^Feta, Aa^Feta, Aa^Fma, Aa^Fma, Aa^Fda, Aa^Fma, Aa, Aa^Fma, Aa, Aa, Aa^Fma, Aa, Aa, Rd, Rd, Aa, Aa, Aa, Rd, Aa, Aa
Aa^Fda, Aa^Fda, Aa^Fda, Aa^Fda, Aa^Fda, Aa^Feta, Aa^Fda, Aa^Fda, Aa^Fda, Aa^Fda, Aa^Fda, Aa^Vea, Aa^Fma, Aa^Fma, Aa^Fma, Aa^Fma, Aa^Feta, Aa^Fda, Aa^Fda, Aa^Feta, Aa^Feta, Aa^Feta, Aa^Feta, Aa^Feta, Aa^Feta, Aa^Feta, Rb, Aa^Feta, Aa^Feta, Aa^Fma, Aa^Fma, Aa^Fma, Aa^Fma, Aa^Fma, Aa^Fma, Aa^Fma, Aa, Aa, Aa, Aa, Aa^Fma, Aa, Aa^Fma, Aa, Aa^Fma, Aa^Fma
Aa^Fda, Aa^Vha, Aa^Fda, Aa^Fda, Aa^Fma, Aa^Fma, Aa^Fma, Aa^Fda, Aa^Fda, Aa^Fda, Aa^Fda, Aa^Fma, Aa^Fda, Aa^Fma, Aa^Fda, Aa^Fma, Aa^Fma, Aa^Fda, Aa^Fda, Aa^Fda, Aa^Feta, Aa^Feta, Aa^Feta, Aa^Feta, Aa^Feta, Rb, Aa^Feta, Aa^Feta, Aa^Feta, Aa^Feta, Aa^Feta, Aa^Fma, Aa^Fma, Aa^Fma, Aa^Fma, Aa^Fma, Aa^Fma, Aa, Aa^Fma, Aa^Fma, Aa^Fma, Aa^Fma, Aa^Fma, Aa^Fma, Aa^Fma, Aa^Fma
Aa^Fda, Aa^Fma, Aa^Fma, Aa^Fma, Aa^Fma, Aa^Fda, Aa^Feta, Aa^Fda, Rb, Aa^Feta, Aa^Feta, Aa^Fda, Aa^Feta, Aa^Fda, Aa^Feta, Aa^Fda, Aa^Feta, Aa^Fma, Aa^Fda, Aa^Feta, Rb, Aa^Feta, Aa^Feta, Aa^Feta, Aa^Feta, Aa^Feta, Aa^Fpa, Aa^Feta, Aa^Feta, Rb, Rb, Aa^Feta, Aa^Feta, Aa^Fma, Aa, Aa^Fma, Aa^Fma, Aa^Fma, Aa^Fma, Aa^Vha, Aa^Fma, Aa^Fma, Aa^Fma, Aa^Feta, Aa^Fma, Aa^Fma
Aa^Feta, Aa^Fda, Aa^Feta, Aa^Fda, Aa^Feta, Aa^Feta, Aa^Feta, Aa^Feta, Aa^Feta, Rb, Aa^Feta, Rb, Aa^Feta, Aa^Feta, Rb, Rb, Aa^Feta, Aa^Feta, Aa^Feta, Rb, Aa^Feta, Aa^Feta, Aa^Feta, Aa^Feta, Aa^Fpa, Aa^Fpa, Aa^Fpa, Aa^Fpa, Aa^Fpa, Aa^Feta, Aa^Fpa, Rb, Rb, Rb, Aa, Aa^Fma, Aa^Fma, Aa^Fma, Aa^Fda, Aa^Fma, Aa^Fma, Aa^Fma, Aa^Fma, Aa^Fda, Aa^Fma, Aa^Fma
Aa^Feta, Aa^Feta, Rb, Aa^Feta, Rb, Rb, Aa^Feta, Aa^Feta, Aa^Feta, Aa^Feta, Aa^Feta, Aa^Feta, Aa^Feta, Aa^Feta, Aa^Feta, Aa^Feta, Aa^Feta, Aa^Feta, Aa^Feta, Aa^Feta, Aa^Fpa, Aa^Fpa, Aa^Fpa, Aa^Fpa, Aa^Fma, Aa^Fpa, Aa^Fma, Aa^Fpa, Aa^Fma, Aa^Fpa, Aa^Fpa, Aa^Fpa, Aa^Fpa, Aa, Aa^Fda, Aa^Fda, Rb, Aa, Rb, Aa, Rb, Aa^Fma, Aa^Fma, Aa^Fda, Aa^Fma, Aa^Fda
Aa^Feta, Rb, Aa^Feta, Aa^Feta, Aa^Feta, Aa^Feta, Aa^Fpa, Aa^Feta, Aa^Fpa, Aa^Fpa, Aa^Fpa, Aa^Fpa, Aa^Fpa, Aa^Fpa, Aa^Fpa, Aa^Feta, Aa^Feta, Aa^Feta, Aa^Feta, Aa^Fpa, Aa^Fpa, Aa^Feta, Aa^Fpa, Aa^Fpa, Aa^Fpa, Aa^Fma, Aa^Fpa, Aa^Fma, Aa^Fpa, Aa^Fpa, Aa^Fma, Aa^Feta, Aa^Fpa, Aa^Fda, Aa^Fpa, Aa, Aa, Rb, Rb, Rb, Rb, Rb, Rb, Aa^Fma, Aa, Aa
Aa^Feta, Aa^Feta, Aa^Feta, Aa^Feta, Aa^Fpa, Aa^Fpa, Aa^Fpa, Aa^Fpa, Aa^Fpa, Aa^Feta, Aa^Fpa, Aa^Vea, Aa^Fpa, Aa^Fpa, Aa^Fpa, Aa^Feta, Rb, Aa^Feta, Aa^Feta, Aa^Fpa, Aa^Fpa, Aa^Fpa, Aa^Fpa, Aa^Fpa, Aa^Fpa, Aa^Fpa, Aa^Fpa, Aa^Fpa, Aa^Fpa, Aa^Fpa, Aa^Fpa, Aa^Fpa, Aa^Fpa, Aa^Fpa, Aa^Fpa, Aa^Fpa, Aa^Fda, Aa, Aa, Aa, Aa, Aa, Aa, Rb, Aa, Aa
Aa^Fpa, Aa^Feta, Aa^Fpa, Aa^Fpa, Aa^Fpa, Aa^Fpa, Aa^Fpa, Aa^Fpa, Aa^Fma, Aa^Fpa, Aa^Fma, Aa^Fpa, Aa^Feta, Aa^Feta, Rb, Rb, Aa^Feta, Aa^Feta, Aa^Fpa, Aa^Fpa, Aa, Aa^Fpa, Aa, Aa^Fpa, Aa, Aa^Fpa, Aa, Aa^Fpa, Aa, Aa^Fpa, Aa^Fpa, Aa^Fpa, Aa^Fpa, Aa^Fpa, Aa^Fpa, Aa^Fda, Aa^Fda, Aa^Fda, Aa^Fda, Aa, Aa^Fda, Aa, Aa^Fda, Aa, Aa^Fda, Aa
Aa^Fpa, Aa^Fpa, Aa^Fpa, Aa^Vea, Aa^Fma, Aa^Fpa, Aa^Fpa, Aa^Fpa, Aa^Fpa, Aa^Fma, Aa^Feta, Aa^Feta, Aa^Feta, Rb, Aa^Feta, Aa^Feta, Aa^Fpa, Aa^Fpa, Aa^Fpa, Aa, Rb, Rb, Rb, Aa, Rb, Aa, Aa, Aa, Aa, Aa, Aa^Fpa, Aa^Fpa, Aa^Fpa, Aa, Aa, Aa^Fda, Aa, Aa^Fda, Aa^Fda, Aa^Fda, Aa^Fda, Aa^Fda, Aa^Fda, Aa^Feta, Aa^Fda, Aa
Aa^Fpa, Aa^Fpa, Aa^Fma, Aa^Fpa, Aa^Fpa, Aa^Fpa, Aa^Fpa, Aa^Fpa, Aa^Feta, Aa^Feta, Rb, Aa^Feta, Aa^Feta, Aa^Feta, Aa^Fpa, Aa^Fpa, Aa^Fpa, Aa^Fpa, Aa^Fpa, Aa, Aa, Aa, Aa, Rb, Aa, Rb, Aa, Aa, Aa^Fpa, Aa^Fpa, Aa^Fpa, Aa^Fpa, Aa^Fpa, Aa, Aa, Aa, Rb, Aa, Aa, Aa^Fda, Aa^Fda, Aa^Fda, Aa^Fda, Aa^Fda, Ha^Fda, Ha^Fda
Aa^Fpa, Aa^Fpa, Aa^Feta, Aa^Fpa, Aa^Fpa, Aa^Fpa, Aa^Feta, Aa^Feta, Aa^Feta, Aa^Feta, Aa^Feta, Aa^Feta, Aa^Feta, Aa^Fpa, Aa^Fpa, Aa^Fpa, Aa^Feta, Aa^Fma, Aa^Fma, Aa^Fma, Aa^Fma, Aa^Fma, Aa^Fma, Aa, Aa, Aa, Aa^Fpa, Aa, Aa^Fpa, Aa^Fpa, Aa^Vea, Aa^Fpa, Aa^Fpa, Aa^Fpa, Aa, Rb, Aa, Aa, Aa, Aa, Aa, Aa, Ha^Fda, Ha^Fda, Ha^Fma, Ha^Fda
Aa^Fpa, Aa^Fpa, Aa^Fpa, Aa^Fpa, Aa, Aa^Fpa, Rb, Rb, Aa^Feta, Aa^Feta, Aa^Fma, Aa^Feta, Aa^Fpa, Aa^Fpa, Aa^Fpa, Aa^Fpa, Aa^Fma, Aa^Fma, Aa^Fpa, Aa^Fpa, Aa^Fpa, Aa, Aa^Fpa, Aa^Fpa, Aa, Aa, Aa^Fpa, Aa^Fpa, Aa^Fpa, Aa^Fpa, Aa^Fma, Aa^Fpa, Aa^Fpa, Aa^Fpa, Aa^Fda, Aa, Aa, Aa, Aa, Aa, Rb, Rb, Ha^Fda, Ha^Fda, Coa, Koa
Aa^Fpa, Aa^Fpa, Cea, Cea, Cea, Rb, Aa^Fma, Aa^Fma, Aa^Fma, Aa^Fma, Aa^Fma, Aa^Fma, Aa^Fpa, Aa^Fpa, Aa^Fpa, Aa^Fma, Aa^Fma, Aa^Fpa, Aa^Fpa, Aa^Fpa, Aa^Fma, Aa^Fpa, Aa^Fpa, Aa^Fpa, Aa^Fpa, Aa, Aa^Fpa, Aa^Fpa, Aa^Fma, Aa^Fma, Aa^Fpa, Aa^Fma, Aa^Feta, Aa^Fpa, Aa^Fpa, Aa^Fda, Aa^Fda, Aa^Fda, Aa^Fda, Aa, Ha^Fda, Ha^Fda, Koa, Coa, 4 Koa, Coa
Aa, Aa, Rb, 1 Kea, Cea, Aa, Aa^Fma, Aa^Fma, Aa^Fma, Aa^Fma, Aa^Feta, Aa^Fma, Aa^Fma, Aa^Vea, Aa^Fma, Aa^Fma, Aa^Fpa, Aa^Fpa, Aa^Fpa, Aa^Fpa, Aa^Fpa, Aa^Fpa, Aa^Feta, Aa^Fpa, Aa^Fpa, Aa^Fpa, Aa^Fpa, Aa^Fpa, Aa^Fpa, Aa^Fma, Aa^Fpa, Aa^Fpa, Aa^Fpa, Aa^Fpa, Aa^Fpa, Aa^Fpa, Aa^Fda, Aa^Fda, Aa^Fda, Aa^Fda, Ha^Fda, Ha^Fma, Coa, Coa, Coa, Coa
Aa, Rb, Aa, Aa, Aa^Fma, Aa^Fma, Aa^Fma, Aa^Fma, Aa^Fma, Aa^Fma, Aa^Fma, Aa^Fma, Aa^Fpa, Aa^Fma, Aa^Fpa, Aa^Fpa, Aa^Fpa, Aa^Fpa, Aa^Fpa, Aa^Fpa, Aa^Fma, Aa^Fpa, Aa^Fpa, Aa^Fpa, Aa^Fpa, Aa^Fpa, Aa^Fpa, Aa^Fpa, Aa^Fpa, Aa^Fpa, Aa^Fpa, Aa^Fpa, Aa^Fpa, Aa^Fpa, Aa^Fpa, Aa^Fpa, Aa^Fpa, Aa^Fda, Ha^Fda, Ha^Fda, Ha^Fda, Ha^Fda, Koa, Coa, Coa, Coa
