Urb, Urb, Urb, Urb, Urb, Xuc, Xuc, Xuc, Urb, Xuc, Xuc, Xuc, Xuc, Xuc, Xuc, Xuc, Xuc, Xuc, Xuc, Urb, Urb, Urb, Urb, Urb, Xuc, Xuc, Xuc, Xuc, Xuc, Xuc, Xuc, Xuc, Xuc, Xuc, Urb, Urb, Xuc, Xuc, Xuc, Xuc, Xuc, Xuc
Xuc, Urb, Xuc, Urb, Xuc, Urb, Urb, Urb, Urb, Urb, Urb, Rr^Vd, Urb, Xuc, Xuc, Xuc, Xuc, Xuc, Xuc, Rr^Vd, Urb, Urb, Urb, Urb, Xuc, Xuc, Xuc, Xuc, Xuc, Xuc, Xuc, Xuc, Urb, Urb, Xuc, Xuc, Xuc, Xuc, Xuc, Xuc, Xuc, Xuc
Xuc, Xuc, Xuc, Xuc, Xuc, Xuc, Xuc, Xuc, Xuc, Xuc, Xuc, Xuc, Xuc, Urb, Urb, Xuc, Xuc, Xuc, Xuc, Xuc, Xuc, Urb, Cud, Urb, Xuc, Xuc, Xuc, Xuc, Xuc, Rr^Vd, Urb, Urb, Xuc, Urb, Urb, Xuc, Xuc, Xuc, Xuc, Xuc, Xuc, Xuc
Xuc, Xuc, Xuc, Xuc, Xuc, Xuc, Xuc, Xuc, Xuc, Xuc, Xuc, Xuc, Xuc, Xuc, Xuc, Urb, Urb, Xuc, Xuc, Xuc, Xuc, Xuc, Cud, Xuc, Xuc, Xuc, Xuc, Xuc, Urb, Urb, Xuc, Xuc, Xuc, Xuc, Xuc, Urb, Urb, Xuc, Xuc, Xuc, Xuc, Xuc
Xuc, Xuc, Xuc, Xuc, Xuc, Xuc, Xuc, Xuc, Xuc, Xuc, Xuc, Xuc, Xuc, Xuc, Xuc, Xuc, Xuc, Urb, Cud, Xuc, Cud, Cud, Kud, Cud, Cud, Xuc, Cud, Urb, Xuc, Xuc, Xuc, Xuc, Xuc, Xuc, Xuc, Xuc, Xuc, Urb, Xuc, Xuc, Xuc, Xuc
Urb, Urb, Urb, Urb, Urb, Urb, Urb, Urb, Urb, Xuc, Urb, Xuc, Xuc, Xuc, Xuc, Xuc, Xuc, Xuc, Xuc, Cud, Kud, Xu, Cud, Xu, Kud, Cud, Xuc, Xuc, Xuc, Xuc, Xuc, Xuc, Xuc, Xuc, Xuc, Xuc, Xuc, Xuc, Xuc, Xuc, Xuc, Xuc
Xuc, Xuc, Xuc, Xuc, Xuc, Xuc, Xuc, Urb, Xuc, Urb, Urb, Urb, Urb, Rr^Vd, Urb, Xuc, Xuc, Xuc, Xuc, Cud, Xu, Cud, 7 Kud, Cud, Xu, Cud, Xuc, Xuc, Xuc, Xuc, Xuc, Xuc, Xuc, Xuc, Xuc, Xuc, Xuc, Xuc, Xuc, Xuc, Xuc, Xuc
Xuc, Xuc, Xuc, Xuc, Uu^Vud, Xuc, Uu, Xuc, Uu, Xuc, Xuc, Xuc, Xuc, Urb, Xuc, Urb, Urb, Xuc, Xuc, Cud, Kud, Cud, Cud, Cud, Kud, Cud, Xuc, Xuc, Xuc, Xuc, Xuc, Xuc, Xuc, Xuc, Xuc, Xuc, Xuc, Xuc, Xuc, Xuc, Xuc, Xuc
Xuc, Xuc, Uu, Uu, Ur, Uu, Co, Uu, Ur, Uu, Uu^Vud, Xuc, Xuc, Xuc, Xuc, Xuc, Xuc, Urb, Cud, Cud, Cud, Xu, Kud, Xu, Cud, Cud, Cud, Xuc, Xuc, Xuc, Xuc, Xuc, Xuc, Xuc, Xuc, Xuc, Xuc, Xuc, Xuc, Xuc, Xuc, Xuc
Uu, Uu, Ur, Ur, Co, Co, Co, Co, Co, Ur, Ur, Uu, Uu, Xuc, Xuc, Xuc, Xuc, Xuc, Xuc, Xuc, Xuc, Cud, Cud, Cud, Urb, Urb, Urb, Xuc, Xuc, Xuc, Xuc, Xuc, Xuc, Xuc, Xuc, Xuc, Xuc, Xuc, Xuc, Xuc, Xuc, Xuc
Xuc, Uu, Co, Co, Co, Co, 6 Kud, Co, Co, Ur, Ur, Xuc, Uu, Xuc, Xuc, Xuc, Xuc, Xuc, Xuc, Xuc, Xuc, Xuc, Cud, Urb, Xuc, Urb, Rr^Vd, Xuc, Xuc, Xuc, Xuc, Xuc, Xuc, Xuc, Xuc, Xuc, Xuc, Xuc, Xuc, Xuc, Xuc, Xuc
Xuc, Uu^Vud, Ur, Co, Co, Co, Co, Co, Co, Ur, Xuc, Ur, Uu^Vud, Xuc, Xuc, Xuc, Xuc, Xuc, Xuc, Xuc, Xuc, Xuc, Xuc, Xuc, Xuc, Uu, Ur, Xuc, Xuc, Xuc, Xuc, Xuc, Xuc, Xuc, Xuc, Xuc, Xuc, Xuc, Xuc, Xuc, Xuc, Xuc
Xuc, Uu, Xuc, Ur, Ur, Uu, Uu, Co, Xuc, Ur, Uu, Uu, Xuc, Xuc, Xuc, Xuc, Xuc, Xuc, Xuc, Xuc, Xuc, Xuc, Xuc, Xuc, Xuc, Xuc, Uu, Ur, Uu^Vud, Xuc, Xuc, Xuc, Xuc, Xuc, Xuc, Xuc, Xuc, Xuc, Xuc, Xuc, Xuc, Xuc
Xuc, Uu, Xuc, Xuc, Xuc, Xuc, Xuc, Uu, Xuc, Uu, Uu, Xuc, Xuc, Xuc, Xuc, Xuc, Ur, Xuc, Ur, Xuc, Ur, Xuc, Ur, Xuc, Xuc, Xuc, Xuc, Uu, Uu, Ur, Ur, Xuc, Xuc, Xuc, Xuc, Xuc, Xuc, Xuc, Xuc, Xuc, Xuc, Xuc
Xuc, Uu, Uu, Ur, Ur, Xuc, Xuc, Uu, Uu, Uu, Uu^Vud, Xuc, Xuc, Xuc, Ur, Ur, Ur, Ur, Ur, Ur, Cud, Ur, Ur, Ur, Xuc, Xuc, Xuc, Xuc, Xuc, Uu, Uu, Uu, Uu, Xuc, Xuc, Xuc, Xuc, Xuc, Xuc, Xuc, Xuc, Xuc
Xuc, Xuc, Uu^Vud, Ur, Ur, Ur, Uu, Xuc, Uu, Xuc, Uu, Xuc, Xuc, Xuc, Ur, Ur, Ur, Ur, Cud, Cud, 8 Ko, Cud, Cud, Ur, Ur, Xuc, Xuc, Xuc, Xuc, Xuc, Xuc, Uu, Uu, Ur, Ur, Xuc, Xuc, Xuc, Xuc, Xuc, Xuc, Xuc
Xuc, Xuc, Xuc, Uu, Uu, Uu, Xuc, Uu, Xuc, Uu, Uu, Xuc, Xuc, Xuc, Ur, Ur, Ur, Ur, Ur, Cud, Cud, Cud, Ur, Ur, Ur, Xuc, Xuc, Xuc, Xuc, Xuc, Xuc, Xuc, Xuc, Uu^Vud, Ur, Ur, Ur, Xuc, Xuc, Xuc, Xuc, Xuc
Xuc, Xuc, Xuc, Xuc, Xuc, Xuc, Xuc, Xuc, Xuc, Uu, Uu, Xue, Xue, Xuc, Xuc, Ur, Ur, Ur, Ur, Ur, Ur, Ur, Ur, Ur, Ur, Xuc, Xuc, Xuc, Xuc, Xuc, Xuc, Xuc, Xuc, Xuc, Xuc, Ur, Ur, Ur, Ur, Xuc, Xuc, Xuc
Xuc, Xuc, Xuc, Xuc, Xuc, Xuc, Xuc, Xuc, Xuc, Xue, Xue, Xue, Ur, Xue, Xuc, Ur, Ur, Ur, Ur, Ur, Ur, Ur, Ur, Ur, Ur, Ur, Uu^Vu, Xuc, Xuc, Xuc, Xuc, Xuc, Xuc, Xuc, Xuc, Xuc, Xuc, Xuc, Uu, Ur, Xuc, Xuc
Xuc, Xuc, Xuc, Xuc, Xuc, Xuc, Xuc, Xuc, Xuc, Xue, Uu^Vud, Tb^Tf, Ur, Xuc, Xuc, Xuc, Xuc, Ur, Ur, Ur, Ur, Ur, Ur, Ur, Uu, Ur, Ur, Uu, Xuc, Xuc, Xuc, Xuc, Xuc, Xuc, Xuc, Xuc, Xuc, Uu, Ur, Ur, Xuc, Xuc
Xuc, Xuc, Xuc, Xuc, Xuc, Xuc, Xuc, Xuc, Xuc, Xuc, Uu, Xuc, Xuc, Ur, Xuc, Xuc, Xuc, Xuc, Xuc, Xuc, Xuc, Xuc, Xuc, Xuc, Xuc, Ur, Ur, Uu, Uu, Xuc, Xuc, Xuc, Xuc, Xuc, Xuc, Xuc, Ur, Ur, Ur, Uu, Xuc, Xuc
Xuc, Xuc, Xuc, Xuc, Xuc, Xuc, Xuc, Xuc, Xuc, Xuc, Tb^Tf, Xuc, Xuc, Ur, Uu^Vu, Xuc, Xuc, Xuc, Xuc, Xuc, Xuc, Xuc, Xuc, Xuc, Xuc, Uu^Vud, Uu, Ur, Ur, Xuc, Xuc, Xuc, Xuc, Xuc, Xuc, Xuc, Ur, Ur, Ur, Uu^Vud, Xuc, Xuc
Xuc, Xuc, Xuc, Xuc, Xuc, Xuc, Xuc, Xuc, Xuc, Xuc, Xuc, Uu, Uu, Xuc, Xuc, Ur, Ur, Xuc, Xuc, Xuc, Xuc, Xuc, Xuc, Xuc, Xuc, Xuc, Xuc, Uu, Ur, Uu, Ur, Xuc, Uu^Vud, Xuc, Ur, Xuc, Ur, Ur, Uu, Uu, Tb^Tf, Xuc
Xuc, Xuc, Xuc, Xuc, Xuc, Xuc, Xuc, Xuc, Xuc, Xuc, Xuc, Xuc, Ur, Ur, Ur, Uu, Uu, Ur, Ur, Ur, Ur, Tb^Tf, Ur, Uu^Vu, Ur, Ur, Ur, Uu, Ur, Ur, Ur, Uu, Ur, Ur, Uu, Ur, Uu, Ur, Ur, Uu, Xuc, Xuc
Xuc, Xuc, Xuc, Xuc, Xuc, Xuc, Xuc, Xuc, Xuc, Xuc, Xuc, Xuc, Xuc, Ur, Ur, Ur, Ur, Ur, Uu^Vud, Ur, Ur, Ur, Ur, Ur, Ur, Ur, Ur, Ur, Ur, Ur, Xuc, Ur, Xuc, Ur, Xuc, Uu, Xuc, Uu, Xuc, Xuc, Xuc, Xuc
Xuc, Xuc, Xuc, Xuc, Xuc, Xuc, Xuc, Xuc, Xuc, Xuc, Xuc, Xuc, Ur, Ur, Xuc, Xuc, Xuc, Xuc, Xuc, Xuc, Xuc, Xuc, Xuc, Xuc, Xuc, Xuc, Xuc, Ur, Ur, Ur, Xuc, Xuc, Xuc, Xuc, Xuc, Xuc, Xuc, Xuc, Xuc, Xuc, Xuc, Xuc
Xuc, Xuc, Xuc, Xuc, Xuc, Xuc, Xuc, Xuc, Xuc, Xuc, Xuc, Uu^Vu, Ur, Uu, Ql^Bs\, Xuc, Xos, Xuc, Xos, Xuc, Xuc, Xuc, Xuc, Xuc, Xuc, Xuc, Xuc, Ur, Uu, Ur, Xuc, Xuc, Xuc, Xuc, Xuc, Xuc, Xuc, Xuc, Xuc, Xuc, Xuc, Xuc
Xuc, Xuc, Xuc, Xuc, Xuc, Xuc, Xuc, Xuc, Xuc, Xuc, Xuc, Ur, Xuc, Xuc, Xos, Ql^Bs\, Ql^Bs\, Xos, Cud, 5 Kud, Uh, Xos, Xos, Xos, Xos, Xuc, Xuc, Ur, Uu, Uu, Xuc, Xuc, Xuc, Xuc, Xuc, Xuc, Xuc, Xuc, Xuc, Xuc, Xuc, Xuc
Xuc, Xuc, Xuc, Xuc, Xuc, Xuc, Xuc, Xuc, Xuc, Xuc, Ur, Ur, Xuc, Xos, Cud, Cud, Cud, Ql^Bs\, Uh, Uu, Uh, Uu^Vud, Uh, Uu^Vud, Uh, Xos, Xuc, Uu, Ur, Ur, Ur, Xuc, Xuc, Xuc, Xuc, Xuc, Xuc, Xuc, Xuc, Xuc, Xuc, Xuc
Xuc, Xuc, Xuc, Xuc, Xuc, Xuc, Xuc, Xuc, Xuc, Ur, Ur, Ur, Xuc, Xos, Cud, Uh, Uu^Vud, Uu, Uh, Uh, Uu, Uh, Uu, Uu, Uu, Uh, Xos, Xuc, Ur, Ur, Ur, Xuc, Xuc, Xuc, Xuc, Xuc, Xuc, Xuc, Xuc, Xuc, Xuc, Xuc
Xuc, Xuc, Xuc, Xuc, Xuc, Xuc, Xuc, Xuc, Uu, Uu, Ur, Xuc, Xuc, Xos, Cud, Uh, Uh, Uh, Uu, Uu, Uu, Uu, Uu, Uu, Uu, Uu^Vu, Xos, Xuc, Xuc, Ur, Ur, Xuc, Xuc, Xuc, Xuc, Xuc, Xuc, Xuc, Xuc, Xuc, Xuc, Xuc
Xuc, Xuc, Xuc, Xuc, Xuc, Xuc, Tb^Tf, Tb^Tf, Uu, Ur, Xuc, Xuc, Xuc, Xos, Xos, Cud, Cud, Cud, Cud, Uu, Uu, Uu, Uu^Vu, Uu, Uu^Vud, Uu, Xuc, Xuc, Xuc, Uu, Uu, Xuc, Xuc, Xuc, Xuc, Xuc, Xuc, Xuc, Xuc, Xuc, Xuc, Xuc
Xuc, Xuc, Xuc, Xuc, Xuc, Xuc, Uu^Vu, Uu, Ur, Xuc, Ur, Xuc, Xuc, Xuc, Xuc, Xos, Uu, Cud, Xos, 4 Kud, Xos, Uu, Xuc, Xuc, Xuc, Xuc, Xuc, Xuc, Ur, Ur, Uu, Urb, Urb, Uu^Vud, Uu, Xuc, Xuc, Xuc, Xuc, Xuc, Xuc, Xuc
Xuc, Xuc, Xuc, Xuc, Xuc, Xuc, Xuc, Ur, Ur, Ur, Ur, Ur, Ur, Uu, Uu, Uu, Xuc, Xos, Xuc, Xos, Xuc, Xuc, Xuc, Xuc, Xuc, Xuc, Uu, Uu, Ce, Ur, Ur, Uu, Ur, Ur, Ce, Tb^Tf, Xuc, Xuc, Xuc, Xuc, Xuc, Xuc
Xuc, Xuc, Xuc, Xuc, Xuc, Xuc, Xuc, Xuc, Xuc, Ur, Xuc, Ur, Ur, Ur, Ur, Xuc, Xuc, Xuc, Xuc, Xuc, Xuc, Xuc, Ur, Xuc, Ur, Ur, Xuc, Uu, Ce, Ce, Ce, Ur, Ur, Ce, Ke, Tb^Tf, Xuc, Xuc, Xuc, Xuc, Xuc, Xuc
Xuc, Xuc, Xuc, Xuc, Xuc, Xuc, Xuc, Xuc, Xuc, Xuc, Uu, Uu, Uu, Uu, Uu^Vu, Ur, Ur, Ur, Ur, Ur, Ur, Ur, Uu, Uu, Uu, Ur, Xuc, Uu, Ce, Ke, Ce, Ur, Ur, Ce, Ce, Uu, Uu^Vud, Xuc, Xuc, Xuc, Xuc, Xuc
Xuc, Xuc, Xuc, Xuc, Xuc, Xuc, Tb^Tf, Xuc, Uu, Xuc, Uu, Xuc, Xuc, Xuc, Xuc, Xuc, Xuc, Ur, Xuc, Ur, Xuc, Tb^Tf, Xuc, Uu^Vud, Xuc, Xuc, Xuc, Uu^Vud, Uu, Ce, Uu, Uu, Ur, Ce, Ur, Uu, Xuc, Xuc, Xuc, Xuc, Xuc, Xuc
Xuc, Xuc, Xuc, Xuc, Cud, Cud, Cud, Uu, Uu, Uu, Xuc, Xuc, Xuc, Xuc, Xuc, Xuc, Xuc, Xuc, Xuc, Xuc, Xuc, Xuc, Xuc, Xuc, Xuc, Xuc, Xuc, Xuc, Xuc, Uu, Xuc, Uu^Vud, Xuc, Ur, Ur, Uu, 2 Ur, Xuc, Xuc, Xuc, Xuc, Xuc
Xuc, Xuc, Xuc, Cud, Cud, 3 Kud, Cud, Cud, Xuc, Tb^Tf, Xuc, Xuc, Xuc, Xuc, Xuc, Xuc, Xuc, Xuc, Xuc, Xuc, Xuc, Xuc, Xuc, Xuc, Xuc, Xuc, Xuc, Xuc, Xuc, Xuc, Xuc, Xuc, Xuc, Ur, 1 Uu, Uu, Ur, Tb^Tf, Tb^Tf, Xuc, Xuc, Xuc
Xuc, Xuc, Xuc, Xuc, Xuc, Cud, Xuc, Xuc, Xuc, Xuc, Xuc, Xuc, Xuc, Xuc, Xuc, Xuc, Xuc, Xuc, Xuc, Xuc, Xuc, Xuc, Xuc, Xuc, Xuc, Xuc, Xuc, Xuc, Xuc, Xuc, Xuc, Xuc, Xuc, Xuc, Xuc, Ur, Ur, Ur, Uu, Uu^Ii, Uu^Ii, Xuc
Xuc, Xuc, Xuc, Xuc, Xuc, Xuc, Xuc, Xuc, Xuc, Xuc, Xuc, Xuc, Xuc, Xuc, Xuc, Xuc, Xuc, Xuc, Xuc, Xuc, Xuc, Xuc, Xuc, Xuc, Xuc, Xuc, Xuc, Xuc, Xuc, Xuc, Xuc, Xuc, Xuc, Xuc, Xuc, Xuc, Xuc, Ur, Uu, Uu^Ii, Ur^Ii, Ur^Ii
Xuc, Xuc, Xuc, Xuc, Xuc, Xuc, Xuc, Xuc, Xuc, Xuc, Xuc, Xuc, Xuc, Xuc, Xuc, Xuc, Xuc, Xuc, Xuc, Xuc, Xuc, Xuc, Xuc, Xuc, Xuc, Xuc, Xuc, Xuc, Xuc, Xuc, Xuc, Xuc, Xuc, Xuc, Xuc, Xuc, Xuc, Xuc, Xuc, Ur^Ii, Ur^Ii, Ur^Ii
