Urb, Urb, Urb, Urb, Urb, Xoa, Xoa, Xoa, Urb, Xoa, Xoa, Xoa, Xoa, Xoa, Xoa, Xoa, Xoa, Xoa, Xoa, Urb, Urb, Urb, Urb, Urb, Xoa, Xoa, Xoa, Xoa, Xoa, Xoa, Xoa, Xoa, Xoa, Xoa, Urb, Urb, Xoa, Xuc, Xuc, Xuc, Xuc, Xuc
Xoa, Urb, Xoa, Urb, Xoa, Urb, Urb, Urb, Urb, Urb, Urb, Rr^Vd, Urb, Xoa, Xoa, Xoa, Xoa, Xoa, Xoa, Rr^Vd, Urb, Urb, Urb, Urb, Xoa, Xoa, Xoa, Xoa, Xoa, Xoa, Xoa, Xoa, Urb, Urb, Xoa, Xoa, Xuc, Xuc, Xuc, Xuc, Xuc, Xuc
Xoa, Xoa, Xoa, Xoa, Xoa, Xoa, Xoa, Xoa, Xoa, Xoa, Xoa, Xoa, Xoa, Urb, Urb, Xoa, Xoa, Xoa, Xoa, Xoa, Xoa, Urb, Cud, Urb, Xoa, Xoa, Xoa, Xoa, Xoa, Rr^Vd, Urb, Urb, Xoa, Urb, Urb, Xoa, Xoa, Xuc, Xuc, Xuc, Xuc, Xuc
Xoa, Xoa, Xoa, Xoa, Xoa, Xoa, Xoa, Xoa, Xoa, Xoa, Xoa, Xoa, Xoa, Xoa, Xoa, Urb, Urb, Xoa, Xoa, Xoa, Xoa, Xoa, Cud, Xoa, Xoa, Xoa, Xoa, Xoa, Urb, Urb, Xoa, Xoa, Xoa, Xoa, Xoa, Urb, Urb, Xoa, Xoa, Xuc, Xuc, Xuc
Xoa, Xoa, Xoa, Xoa, Xoa, Xoa, Xoa, Xoa, Xoa, Xoa, Xoa, Xoa, Xoa, Xoa, Xoa, Xoa, Xoa, Urb, Cud, Xoa, Cud, Cud, Kud, Cud, Cud, Xoa, Cud, Urb, Xoa, Xoa, Xuc, Xuc, Xuc, Xoa, Xuc, Xoa, Xoa, Urb, Xoa, Xuc, Xuc, Xuc
Urb, Urb, Urb, Urb, Urb, Urb, Urb, Urb, Urb, Xoa, Urb, Xoa, Xoa, Xoa, Xoa, Xoa, Xoa, Xoa, Xoa, Cud, Kud, Xoa, Cud, Xoa, Kud, Cud, Xoa, Xoa, Xuc, Xuc, Xuc, Xuc, Xuc, Xuc, Xuc, Xuc, Xuc, Xoa, Xuc, Xuc, Xuc, Xuc
Xuc, Xuc, Xuc, Xuc, Xuc, Xuc, Xuc, Urb, Xuc, Urb, Urb, Urb, Urb, Rr^Vd, Urb, Xoa, Xoa, Xoa, Xoa, Cud, Xoa, Cud, 7 Kud, Cud, Xoa, Cud, Xoa, Xuc, Xuc, Xuc, Xuc, Xuc, Xuc, Xuc, Xuc, Xuc, Xuc, Xuc, Xuc, Xuc, Xuc, Xuc
Xuc, Xuc, Xuc, Xuc, Uu^Vud, Xuc, Uu, Xuc, Uu, Xuc, Xuc, Xoa, Xoa, Urb, Xoa, Urb, Urb, Xoa, Xoa, Cud, Kud, Cud, Cud, Cud, Kud, Cud, Xoa, Xuc, Xuc, Xuc, Xuc, Xuc, Xuc, Xuc, Xuc, Xuc, Xuc, Xuc, Xuc, Xuc, Xuc, Xuc
Xuc, Xuc, Uu, Uu, Ur, Uu, Co, Uu, Ur, Uu, Uu^Vud, Xuc, Xuc, Xoa, Xuc, Xoa, Xoa, Urb, Cud, Cud, Cud, Xoa, Kud, Xoa, Cud, Cud, Cud, Xuc, Xuc, Xuc, Xuc, Xuc, Xuc, Xuc, Xuc, Xuc, Xuc, Xuc, Xuc, Xuc, Xuc, Xuc
Uu, Uu, Ur, Ur, Co, Co, Co, Co, Co, Ur, Ur, Uu, Uu, Xuc, Xuc, Xuc, Xuc, Xoa, Xuc, Xoa, Xoa, Cud, Cud, Cud, Urb, Urb, Urb, Xuc, Xuc, Xuc, Xuc, Xuc, Xuc, Xuc, Xuc, Xuc, Xuc, Xuc, Xuc, Xuc, Xuc, Xuc
Xuc, Uu, Co, Co, Co, Co, 6 Kud, Co, Co, Ur, Ur, Xuc, Uu, Xuc, Xuc, Xuc, Xuc, Xuc, Xuc, Xuc, Xuc, Xoa, Cud, Urb, Xoa, Urb, Rr^Vd, Xoa, Xuc, Xuc, Xuc, Xuc, Xuc, Xuc, Xuc, Xuc, Xuc, Xuc, Xuc, Xuc, Xuc, Xuc
Xuc, Uu^Vud, Ur, Co, Co, Co, Co, Co, Co, Ur, Xuc, Ur, Uu^Vud, Xuc, Xuc, Xuc, Xuc, Xuc, Xuc, Xuc, Xuc, Xoa, Xoa, Xoa, Xuc, Uu, Ur, Xoa, Xoa, Xuc, Xuc, Xuc, Xuc, Xuc, Xuc, Xuc, Xuc, Xuc, Xuc, Xuc, Xuc, Xuc
Xuc, Uu, Xuc, Ur, Ur, Uu, Uu, Co, Xuc, Ur, Uu, Uu, Xuc, Xuc, Xuc, Xuc, Xuc, Xuc, Xuc, Xuc, Xuc, Xoa, Xuc, Xuc, Xuc, Xoa, Uu, Ur, Uu^Vud, Xuc, Xuc, Xuc, Xuc, Xuc, Xuc, Xuc, Xuc, Xuc, Xuc, Xuc, Xuc, Xuc
Xuc, Uu, Xuc, Xuc, Xuc, Xuc, Xuc, Uu, Xuc, Uu, Uu, Uu, Xuc, Xuc, Xuc, Xuc, Ur, Xuc, Ur, Xuc, Ur, Xuc, Ur, Xuc, Xuc, Xoa, Xoa, Uu, Uu, Ur, Ur, Xuc, Xuc, Xuc, Xuc, Xuc, Xuc, Xuc, Xuc, Xuc, Xuc, Xuc
Xuc, Uu, Uu, Ur, Ur, Xuc, Xuc, Uu, Uu, Uu, Uu^Vud, Uu, Xuc, Xuc, Ur, Ur, Ur, Ur, Ur, Ur, Cud, Ur, Ur, Ur, Xuc, Xuc, Xuc, Xuc, Xuc, Uu, Uu, Ur, Uu, Xuc, Xuc, Xuc, Xuc, Xuc, Xuc, Xuc, Xuc, Xuc
Xuc, Xuc, Uu^Vud, Ur, Ur, Ur, Uu, Xuc, Uu, Xuc, Uu, Xuc, Xuc, Xuc, Ur, Ur, Ur, Ur, Cud, Cud, 8 Ko, Cud, Cud, Ur, Ur, Xuc, Xuc, Xuc, Xuc, Uu, Uu, Ur, Uu, Ur, Ur, Xuc, Xuc, Xuc, Xuc, Xuc, Xuc, Xuc
Xuc, Xuc, Xuc, Uu, Uu, Uu, Uu, Uu, Xuc, Uu, Uu, Xuc, Xuc, Xuc, Ur, Ur, Ur, Ur, Ur, Cud, Cud, Cud, Ur, Ur, Ur, Xuc, Xuc, Xuc, Uu, Uu, Ur, Ur, Xuc, Uu^Vud, Ur, Ur, Ur, Xuc, Xuc, Xuc, Xuc, Xuc
Xuc, Xuc, Xuc, Xuc, Xuc, Xuc, Xuc, Uu, Uu, Uu, Uu, Uu, Xue, Xuc, Xuc, Ur, Ur, Ur, Ur, Ur, Ur, Ur, Ur, Ur, Ur, Xuc, Xuc, Xuc, Uu, Uu, Ur, Xuc, Xuc, Xuc, Xuc, Ur, Ur, Ur, Ur, Xuc, Xuc, Xuc
Xuc, Xuc, Xuc, Xuc, Xuc, Xuc, Xuc, Xuc, Xuc, Xue, Xue, Xue, Ur, Xue, Xuc, Ur, Ur, Ur, Ur, Ur, Ur, Ur, Ur, Ur, Ur, Ur, Uu^Vu, Uu, Uu, Ur, Xuc, Xuc, Xuc, Xuc, Xuc, Xuc, Xuc, Ur, Uu, Ur, Xuc, Xuc
Xuc, Xuc, Xuc, Xuc, Xuc, Xuc, Xuc, Xuc, Xuc, Xue, Uu^Vud, Tb^Tf, Ur, Xuc, Xuc, Xuc, Xuc, Ur, Ur, Ur, Ur, Ur, Ur, Ur, Uu, Ur, Ur, Uu, Ur, Ur, Xuc, Xuc, Xuc, Xuc, Xuc, Xuc, Xuc, Uu, Ur, Ur, Xuc, Xuc
Xuc, Xuc, Xuc, Xuc, Xuc, Xuc, Xuc, Xuc, Xuc, Xuc, Uu, Xuc, Xuc, Ur, Xuc, Xuc, Xuc, Xuc, Xuc, Xuc, Xuc, Xuc, Xuc, Xuc, Xuc, Ur, Ur, Ur, Ur, Xuc, Xuc, Xuc, Xuc, Xuc, Xuc, Xuc, Ur, Ur, Ur, Uu, Xuc, Xuc
Xuc, Xuc, Xuc, Xuc, Xuc, Xuc, Xuc, Xuc, Xuc, Xuc, Tb^Tf, Xuc, Xuc, Ur, Uu^Vu, Xuc, Xuc, Xuc, Xuc, Xuc, Xuc, Xuc, Xuc, Xuc, Xuc, Uu^Vud, Uu, Ur, Ur, Xuc, Xuc, Xuc, Xuc, Xuc, Xuc, Xuc, Ur, Ur, Ur, Uu^Vud, Xuc, Xuc
Xuc, Xuc, Xuc, Xuc, Xuc, Xuc, Xuc, Xuc, Xuc, Xuc, Xuc, Uu, Uu, Xuc, Xuc, Ur, Ur, Xuc, Xuc, Xuc, Xuc, Xuc, Xuc, Xuc, Xuc, Xuc, Xuc, Uu, Ur, Uu, Ur, Xuc, Uu^Vud, Xuc, Ur, Xuc, Ur, Ur, Uu, Uu, Tb^Tf, Xuc
Xuc, Xuc, Xuc, Xuc, Xuc, Xuc, Xuc, Xuc, Xuc, Xuc, Xuc, Xuc, Ur, Ur, Ur, Uu, Uu, Ur, Ur, Ur, Ur, Tb^Tf, Ur, Uu^Vu, Ur, Ur, Ur, Uu, Ur, Ur, Ur, Uu, Ur, Ur, Uu, Ur, Uu, Ur, Ur, Uu, Xuc, Xuc
Xuc, Xuc, Xuc, Xuc, Xuc, Xuc, Xuc, Xuc, Xuc, Xuc, Xuc, Xuc, Xuc, Ur, Ur, Ur, Ur, Ur, Uu^Vud, Ur, Ur, Ur, Ur, Ur, Ur, Ur, Ur, Ur, Ur, Ur, Xuc, Ur, Xuc, Ur, Xuc, Uu, Xuc, Uu, Xuc, Xuc, Xuc, Xuc
Xuc, Xuc, Xuc, Xuc, Xuc, Xuc, Xuc, Xuc, Xuc, Xuc, Xuc, Xuc, Ur, Ur, Xuc, Xuc, Xuc, Xuc, Xuc, Xuc, Xuc, Xuc, Xuc, Xuc, Xuc, Xuc, Xuc, Ur, Ur, Ur, Xuc, Xuc, Xuc, Xuc, Xuc, Xuc, Xuc, Xuc, Xuc, Xuc, Xuc, Xuc
Xuc, Xuc, Xuc, Xuc, Xuc, Xuc, Xuc, Xuc, Xuc, Xuc, Xuc, Uu^Vu, Ur, Uu, Ql^Bs\, Xuc, Xos, Xuc, Xos, Xuc, Xuc, Xuc, Xuc, Xuc, Xuc, Xuc, Xuc, Ur, Uu, Ur, Xuc, Xuc, Xuc, Xuc, Xuc, Xuc, Xuc, Xuc, Xuc, Xuc, Xuc, Xuc
Xuc, Xuc, Xuc, Xuc, Xuc, Xuc, Xuc, Xuc, Xuc, Xuc, Xuc, Ur, Xuc, Xuc, Xos, Ql^Bs\, Ql^Bs\, Xos, Cud, 5 Kud, Uh, Xos, Xos, Xos, Xos, Xuc, Xuc, Ur, Uu, Uu, Xuc, Xuc, Xuc, Xuc, Xuc, Xuc, Xuc, Xuc, Xuc, Xuc, Xuc, Xuc
Xuc, Xuc, Xuc, Xuc, Xuc, Xuc, Xuc, Xuc, Xuc, Xuc, Ur, Ur, Xuc, Xos, Cud, Cud, Cud, Ql^Bs\, Uh, Uu, Uh, Uu^Vud, Uh, Uu^Vud, Uh, Xos, Xuc, Uu, Ur, Ur, Ur, Xuc, Xuc, Xuc, Xuc, Xuc, Xuc, Xuc, Xuc, Xuc, Xuc, Xuc
Xuc, Xuc, Xuc, Xuc, Xuc, Xuc, Xuc, Xuc, Xuc, Ur, Ur, Ur, Uu, Xos, Cud, Uh, Uu^Vud, Uu, Uh, Uh, Uu, Uh, Uu, Uu, Uu, Uh, Xos, Xuc, Ur, Ur, Ur, Xuc, Xuc, Xuc, Xuc, Xuc, Xuc, Xuc, Xuc, Xuc, Xuc, Xuc
Xuc, Xuc, Xuc, Xuc, Xuc, Xuc, Xuc, Xuc, Uu, Uu, Ur, Xuc, Xuc, Uu, Cud, Uh, Uh, Uh, Uu, Uu, Uu, Uu, Uu, Uu, Uu, Uu^Vu, Xos, Xuc, Uu, Ur, Ur, Xuc, Xuc, Xuc, Xuc, Xuc, Xuc, Xuc, Xuc, Xuc, Xuc, Xuc
Xuc, Xuc, Xuc, Xuc, Xuc, Xuc, Tb^Tf, Tb^Tf, Uu, Ur, Xuc, Xuc, Xuc, Xos, Xos, Cud, Cud, Cud, Cud, Uu, Uu, Uu, Uu^Vu, Uu, Uu^Vud, Uu, Xuc, Xuc, Uu, Uu, Uu, Xuc, Xuc, Xuc, Xuc, Xuc, Xuc, Xuc, Xuc, Xuc, Xuc, Xuc
Xuc, Xuc, Xuc, Xuc, Xuc, Xuc, Uu^Vu, Uu, Ur, Xuc, Ur, Xuc, Xuc, Xuc, Uu, Uu, Uu, Cud, Xos, 4 Kud, Xos, Uu, Xuc, Xuc, Xuc, Xuc, Xuc, Xuc, Ur, Ur, Uu, Urb, Urb, Uu^Vud, Uu, Xuc, Xuc, Xuc, Xuc, Xuc, Xuc, Xuc
Xuc, Xuc, Xuc, Xuc, Xuc, Xuc, Xuc, Ur, Ur, Ur, Ur, Ur, Ur, Uu, Uu, Uu, Xuc, Xos, Xuc, Xos, Xuc, Xuc, Xuc, Xuc, Xuc, Xuc, Uu, Uu, Ce, Ur, Ur, Uu, Ur, Ur, Ce, Tb^Tf, Xuc, Xuc, Xuc, Xuc, Xuc, Xuc
Xuc, Xuc, Xuc, Xuc, Xuc, Xuc, Xuc, Xuc, Xuc, Ur, Xuc, Ur, Ur, Ur, Ur, Xuc, Uu, Xuc, Uu, Xuc, Xuc, Xuc, Ur, Xuc, Ur, Ur, Uu, Uu, Ce, Ce, Ce, Ur, Ur, Ce, Ke, Tb^Tf, Xuc, Xuc, Xuc, Xuc, Xuc, Xuc
Xuc, Xuc, Xuc, Xuc, Xuc, Xuc, Xuc, Xuc, Uh, Xuc, Uu, Uu, Uu, Uu, Uu^Vu, Ur, Ur, Ur, Ur, Ur, Ur, Ur, Uu, Uu, Uu, Ur, Xuc, Uu, Ce, Ke, Ce, Ur, Ur, Ce, Ce, Uu, Uu^Vud, Xuc, Xuc, Xuc, Xuc, Xuc
Xuc, Xuc, Xuc, Xuc, Xuc, Xuc, Tb^Tf, Xuc, Uu, Uu, Uh, Uu, Xuc, Xuc, Xuc, Uu, Uu, Ur, Uu, Ur, Uu, Tb^Tf, Xuc, Uu^Vud, Xuc, Xuc, Xuc, Uu^Vud, Uu, Ce, Uu, Uu, Ur, Ce, Ur, Uu, Xuc, Xuc, Xuc, Xuc, Xuc, Xuc
Xuc, Xuc, Xuc, Xuc, Cte, Cte, Cte, Uu, Uu, Uh, Uu, Uh, Xuc, Xuc, Xuc, Xuc, Xuc, Xuc, Xuc, Xuc, Xuc, Xuc, Xuc, Xuc, Xuc, Xuc, Xuc, Xuc, Xuc, Uu, Xuc, Uu^Vud, Xuc, Ur, Ur, Uu, 2 Ur, Xuc, Xuc, Xuc, Xuc, Xuc
Xuc, Xuc, Xuc, Cte, Cte, 3 Kte, Cte, Cte, Xuc, Tb^Tf, Xuc, Xuc, Xuc, Xuc, Xuc, Xuc, Xuc, Xuc, Xuc, Xuc, Xuc, Xuc, Xuc, Xuc, Xuc, Xuc, Xuc, Xuc, Xuc, Xuc, Xuc, Xuc, Xuc, Ur, 1 Uu, Uu, Ur, Tb^Tf, Tb^Tf, Xuc, Xuc, Xuc
Xuc, Xuc, Xuc, Xuc, Xuc, Cte, Xuc, Xuc, Xuc, Xuc, Xuc, Xuc, Xuc, Xuc, Xuc, Xuc, Xuc, Xuc, Xuc, Xuc, Xuc, Xuc, Xuc, Xuc, Xuc, Xuc, Xuc, Xuc, Xuc, Xuc, Xuc, Xuc, Xuc, Xuc, Xuc, Ur, Ur, Ur, Uu, Uu^Ii, Uu^Ii, Xuc
Xuc, Xuc, Xuc, Xuc, Xuc, Xuc, Xuc, Xuc, Xuc, Xuc, Xuc, Xuc, Xuc, Xuc, Xuc, Xuc, Xuc, Xuc, Xuc, Xuc, Xuc, Xuc, Xuc, Xuc, Xuc, Xuc, Xuc, Xuc, Xuc, Xuc, Xuc, Xuc, Xuc, Xuc, Xuc, Xuc, Xuc, Ur, Uu, Uu^Ii, Ur^Ii, Ur^Ii
Xuc, Xuc, Xuc, Xuc, Xuc, Xuc, Xuc, Xuc, Xuc, Xuc, Xuc, Xuc, Xuc, Xuc, Xuc, Xuc, Xuc, Xuc, Xuc, Xuc, Xuc, Xuc, Xuc, Xuc, Xuc, Xuc, Xuc, Xuc, Xuc, Xuc, Xuc, Xuc, Xuc, Xuc, Xuc, Xuc, Xuc, Xuc, Xuc, Ur^Ii, Ur^Ii, Ur^Ii
