Qxu^Bs\, Qxu^Ii, Qxu^Ii, Qxu, Qxu, Qxu, Qxu, Xue, Xue, Xue, Xue, Xue, Xue, Xue, Xue, Xue, Xue, Xue, Xue, Xue, Ql, Ql, Ql, Ql, Ql, Xue, Xue, Xue, Xue, Xue, Xue, Xue, Xue, Xue, Xue, Xue, Xue, Xue, Xue, Xue, Xue, Xue, Xue, Xue, Xue, Xue
Qxu^Ii, Uu^Ii, Uu, Uu, Uu, Uu, Uu, Uu, Uu, Xue, Uu, Uu, Uu, Uu, Xue, Xue, Xue, Xue, Xue, Ql, Ql, Xu, Ql, Ql, Ql, Ql, Ql, Xue, Mm, Xue, Xu^Dr, Xue, Xue, Xue, Uu, Xue, Xue, Xue, Xue, Xue, Ur, Uu, Uu, Uu, Tb^Tf, Xue
Qxu, Uu, Tb^Tf, Uu, Chr, Cfr, Cfr, Uu, Uu^Vu, Xue, Uu, Uu, Uu, Xue, Uu, Uu, Uu, Xue, Xue, Ql, Ql, Ql, Ql^Bs/, Ha^Ii, Tb^Tf, Ql, Ql, Mm, Gg^Efm, Gg^Efm, Xu^Dr, Uu^Vud, Uu, Uu, Xu, Tb^Tf, Ur, Xue, Uu, Uu, Xu, Xu, Xu, Xu, Uu, Xue
Qxu, Uu, Uu, Uu, Chr, 4 Ko, Co, Uu, Uu, Xue, Xue, Tb^Tf, Xue, Xue, Uu, Xue, Xue, Uu, Uu, Xue, Uu, Ql^Bs/, Ql, Ql, Ql, Ql^Bs\, Uu, Hh, Gg^Efm, 5 Gg^Fet, Xue, Xue, Uu, Xu, Xu, Xu, Uu, Xue, Uu, Xu, Uu, Xu, Xu, Xu, Uu, Xue
Xue, Uu, Uu^Vu, Uu, Uu, Co, Uu, Uu, Uu, Xue, Xue, Uu, Uu, Xue, Uu, Xue, Tb^Tf, Xue, Uu, Uu, Xue, Uu, Uu, Xue, Xue, Ql, Ql, Mm, Mm, Gg^Efm, Xue, Ur, Xu, Ur, Ur, Ur, Xue, Uu, Uu, Tb^Tf, Xu, Uu, Uu, Uu, Xue, Xue
Xue, Xue, Xue, Uu, Xue, Uu, Xue, Xue, Ur^Dr, Ur^Dr, Xue, Tb^Tf, Xue, Xue, Uu, Xue, Tb^Tf, Xue, Uu, Xue, Tb^Tf, Xue, Uu, Xue, Xue, Ql, Ql, Xue, Xue, Mm, Xue, Ur, Uu, Uh, Xue, Xue, Xue, Xue, Uu, Xu, Xu, Uu, Xue, Xue, Xue, Xue
Xue, Xue, Xue, Xue, Xue, Xue, Xue, Xue, Uu, Uu, Uu, Tb^Tf, Uu, Uu, Ur, Xue, Uu, Uu, Xue, Xue, Uu, Xue, Uu, Xue, Xue, Xu^Dr, Xu^Dr, Xue, Uu, Ur, Xue, Xue, Uu, Xue, Xue, Xue, Xue, Xue, Uu, Xu, Xu, Ur, Xue, Xue, Xue, Xue
Xue, Xue, Xue, Xue, Xue, Xue, Xue, Uu, Xue, Xue, Xue, Uu, Xue, Xue, Ur, Uu, Xue, Xue, Xue, Xue, Uu, Xue, Uu, Xue, Xue, Xue, Tb^Tf, Ur, Xue, Xue, Xue, Uu, Xue, Xue, Xue, Xue, Tb^Tf, Uu, Ql^Bs|, Uu, Uu, Uu, Xue, Xue, Xue, Xue
Xue, Xue, Xue, Xue, Xue, Xue, Xue, Uu, Xue, Tb^Tf, Uu, Uu, Xue, Xue, Xue, Uu, Xue, Xue, Xue, Xue, Uu, Xue, Uu, Uu, Uu, Xue, Uu, Xue, Ur, Xue, Xue, Ur, Xue, Xue, Uu, Uu, Ql^Bs\, Ql, Chr, Ql, Ql^Bs/, Uu, Uu, Xue, Xue, Xue
Xue, Xue, Xue, Xue, Xue, Xue, Xue, Uu, Xue, Xue, Xue, Xue, Xue, Xue, Xue, Uu, Uu, Xue, Xue, Xue, Xue, Uu, Xue, Xue, Xue, Uu, Uu, Uu, Uu, Ur, Xue, Ur, Xue, Ur, Xu, Xu, Ql, Chr, 3 Khr, Chr, Ql, Xu, Ur, Xue, Xue, Xue
Xue, Xue, Xue, Xue, Xue, Xue, Xue, Uu, Xue, Xue, Uu, Uu, Uu, Xue, Xue, Xue, Uu, Xue, Uu, Xue, Ur, Xue, Xue, Xue, Xue, Xue, Uu, Xue, Xue, Uu, Xue, Tb^Tf, Uu, Uu, Uu, Xu, Xu, Ql, Ql, Ql, Xu, Xu, Uu, Xue, Xue, Xue
Xue, Xue, Xue, Xue, Xue, Xue, Xue, Uu, Xue, Uu, Xue, Xue, Ur, Xue, Uu, Uu, Xue, Xue, Uu, Uu, Xue, Uu, Uu, Xue, Xue, Xue, Uu, Xue, Uu, Uu, Xue, Uu, Xue, Xue, Xue, Uu, Uu, Xu, Xu, Xu, Uu, Tb^Tf, Xue, Xue, Xue, Xue
Xue, Xue, Xue, Xue, Xue, Xue, Xue, Uu, Uu, Uu, Xue, Xue, Ur, Xue, Uu, Xue, Xue, Ur, Uu, Ur, Uu, Xue, Uu, Ur, Xue, Xue, Uu, Xue, Xue, Uu, Xue, Uu, Xue, Xue, Xue, Xue, Xue, Uu, Uu, Uu, Xue, Xue, Xue, Xue, Xue, Xue
Xue, Xue, Xue, Xue, Xue, Xue, Xue, Xue, Xue, Uu, Xue, Xue, Xue, Xue, Xue, Uu, Uu, Xue, Xue, Xue, Xue, Xue, Uu, Uu, Xue, Xue, Uu, Xue, Uu, Uu, Xue, Uu, Xue, Xue, Xue, Xue, Xue, Xue, Xue, Uu, Uu, Xue, Xue, Xue, Xue, Xue
Xue, Xue, Xue, Xue, Xue, Xue, Uu^Vu, Xue, Uu, Xue, Uu, Xue, Uu, Xue, Xue, Xue, Xue, Uu, Uu, Uu, Uu, Uu, Xue, Ur, Xue, Xue, Uu, Xue, Uu, Xue, Ur, Ur, Xue, Xue, Xue, Xue, Xue, Xue, Xue, Xue, Xue, Ur, Uu, Xue, Uu^Vud, Xue
Xue, Xue, Xue, Xue, Xue, Uu, Uu, Ur, Xue, Uu, Xue, Uu, Uu, Ur, Uu, Xue, Xue, Xue, Xue, Xue, Xue, Uu, Xue, Xue, Xue, Xue, Tb^Tf, Xue, Xue, Xue, Uu, Xue, Xue, Xue, Xue, Xue, Xue, Xue, Xue, Xue, Xue, Xue, Uu, Uu, Xue, Xue
Xue, Xue, Xue, Xue, Xue, Ur, Tb^Tf, Uu, Uu, Xue, Ur, Xue, Uu, Uu, Xue, Uu, Uu, Tb^Tf, Uu, Xue, Ur, Uh, Xue, Xue, Xu^Dr, Xue, Xu^Dr, Xue, Xue, Uu, Xue, Xue, Xue, Xue, Xue, Xue, Xue, Xue, Uu, Uu, Uu, Uu, Xue, Xue, Xue, Xue
Xue, Xue, Xue, Xue, Xue, Ur, Xue, Uu, Uu^Vud, Uu, Uu, Uu, Uu, Xue, Uu^Vud, Uu, Uu, Xue, Xue, Uu, Uu, Uu, Uu, Xue, Uh, Xu^Dr, Uh, Xue, Uu, Uu, Uu, Xue, Xue, Xue, Uu, Ur, Uu, Uu, Xue, Uu, Xue, Uu, Ur, Xue, Xue, Xue
Xue, Xue, Xue, Xue, Xue, Uu, Xue, Xue, Xue, Uu, Xue, Uu^Vud, Xue, Xue, Uu, Uu, Ur, Xue, Xue, Xue, Uu, Xue, Xue, Uu, Uu, Uh, Uu, Uu, Uu, Tb^Tf, Uu, Uu^Vu, Uu, Uu, Xue, Xue, Xue, Xue, Xue, Xue, Xue, Uu, Uu, Xue, Xue, Xue
Xue, Xue, Xue, Xue, Xue, Uu, Ur, Xue, Uu, Xue, Uu, Xue, Uu, Xue, Tb^Tf, Ur, Ur, Xue, Uu, Xue, Uu, Uu^Vud, Xue, Uu, Tb^Tf, Uu, Uu, Ur, Ur, Uu, Uu, Uu, Ur, Ur, Xue, Xue, Uu, Uu, Uu, Xue, Uu^Vu, Ur, Uu, Xue, Xue, Xue
Xue, Xue, Xue, Xue, Xue, Xue, Xue, Uu, Xue, Uu, Xue, Ur, Xue, Uu, Xue, Uu, Xue, Uu, Xue, Ur, Xue, Xue, Xue, Xue, Uu, Uu, Tb^Tf, Ur, Uu, Uu, Tb^Tf, Uu, Uu, Xue, Xue, Uu, Xue, Xue, Uu, Uu, Uu, Uu, Xue, Xue, Xue, Xue
Xue, Xue, Xue, Xue, Xue, Xue, Xue, Xue, Xue, Xue, Uu^Vud, Ur, Uu, Xue, Xue, Xue, Xue, Xue, Ur, Xue, Xue, Xue, Xue, Xue, Uu^Vud, Uu, Uu, Uu, Uu, Uu, Uu, Uu, Xue, Xue, Xue, Ur, Ur, Xue, Xue, Uu, Xue, Xue, Xue, Xue, Xue, Xue
Xue, Xue, Xue, Xue, Xue, Xue, Xue, Xue, Xue, Xue, Ql, Ql^Bs|, Ql, Rr, Xue, Xue, Ur, Uu, Xue, Ur, Ur, Xue, Xue, Xue, Xue, Uu, Uu, Uu, Ql, Uu, Uu, Uu, Xue, Xue, Xue, Xue, Xue, Ur, Uu, Xue, Xue, Xue, Xue, Xue, Xue, Xue
Xue, Xue, Xue, Xue, Xue, Xue, Xue, Xue, Ql, Ql, Ur, Ur, Ql, Xue, Uu, Ur, Xue, Xue, Uu^Vu, Xue, Xue, Ur, Tb^Tf, Xue, Xue, Xue, Xue, Ql^Bs\, Uh, Ql^Bs/, Xue, Xue, Xue, Xue, Xue, Xue, Uu, Ur, Xue, Xue, Xue, Xue, Xue, Xue, Xue, Xue
Xue, Xue, Xue, Xue, Xue, Xue, Xue, Xue, Ql, Ql, Ql^Bs|, Ql, Ql, Xue, Uu, Ur, Xue, Uu, Ur, Ur, Xue, Ur, Uu, Xue, Xue, Xue, Uu, Ql^Bs/, Ql, Ql^Bs\, Uu, Xue, Xue, Xue, Xue, Xue, Uu, Uu, Uu, Xue, Xue, Xue, Xue, Xue, Xue, Xue
Xuc, Xue, Xuc, Xuc, Xuc, Xuc, Xuc, Xue, Ql, Ql, Ur, Ql, Ql, Xue, Xue, Ur, Uu, Uu, Xue, Xue, Xue, Ur, Ur, Xue, Ql, Xue, Uu, Uu, Cud, Uu, Uu, Xue, Xue, Xue, Xue, Xue, Xue, Uu, Xue, Xue, Xue, Xue, Uu^Vu, Xue, Xue, Xue
Xuc, Xuc, Xos, Xos, Xos, Xos, Xos, Xuc, Xuc, Ur, Ql, Ql, Xue, Xue, Xue, Xue, Xue, Xue, Xue, Xue, Ur, Ur, Xue, Xue, Ql, Tb^Tf, Uu, Cud, 2 Kud, Cud, Uu, Uu^Vud, Ql^Bs/, Uu, Uu^Vud, Uu, Uu, Uh, Ur, Xue, Xue, Ur, Ur, Xue, Xue, Xue
Xos, Xos, Rr, Rr^Vd, Rr, Cud, Rr, Rr, Rr, Xuc, Xuc, Xue, Xue, Xue, Xue, Xue, Ur, Xue, Xue, Ur, Uu, Uu, Xue, Xue, Ql, Uu^Vud, Uu, Cud, Cud, Cud, Uu, Uu, Ql, Xu, Xu, Xu, Uu, Xu, Xu, Ur, Ur, Ur, Xue, Xue, Xue, Xue
Xos, Rr, Cud, 1 Kud, Cud, Rr, Rr, Rr, Cud, Xos, Xuc, Xue, Xue, Uu, Tb^Tf, Ur, Ur, Uu, Uu, Ur, Xue, Xue, Xue, Xue, Ql, Uu, Tb^Tf, Uu, Uu, Uu, Uu, Tb^Tf, Ql, Ur, Ur, Uu, Uu, Uu, Uu, Ur, Xue, Xue, Xue, Xue, Xue, Xue
Xos, Rr, Cud, Cud, Cud, Cud, Rr, Rr, Uu^Ufi, Xos, Xuc, Xue, Uu, Uu, Ur, Ur, Xue, Ur, Uu, Uu, Uu, Xue, Xue, Xue, Ql, Uu, Uu, Uu, Ql, Ql, Ql, Ql, Xue, Xue, Xue, Ql, Uu, Ql, Uu, Xue, Xue, Xue, Xue, Xue, Xue, Xue
Xos, Rr, Rr, Cud, Cud, Cud, Rr, Rr, Rr, Xos, Xuc, Xue, Uu, Ur, Ur, Xue, Uu^Vu, Xue, Xue, Uu, Uu, Uu, Tb^Tf, Xue, Xue, Ql, Ql^Bs|, Ql, Xue, Xue, Xue, Xue, Xue, Xue, Ur, Uu, Qxu, Uu, Uu, Xue, Xue, Xue, Xue, Xue, Xue, Xue
Xos, Rr, Rr, Rr, Rr, Rr, Rr, Rr, Rr^Vd, Xos, Xuc, Xue, Uu, Ur, Ur, Xue, Xue, Uu, Xue, Xue, Ur, Ur, Uu, Uh, Uh, Xue, Uu, Xue, Xue, Xue, Ur, Ur, Ur, Ur, Xue, Uu, Uu, Uu, Xue, Ur, Ur, Xue, Xue, Xue, Xue, Xue
Xos, Rr^Vd, Rr, Rr, Rr, Rr, Rr^Vd, Rr, Xos, Xos, Xuc, Xue, Xue, Tb^Tf, Ur, Ur, Ur, Ur, Xue, Xue, Xue, Ur, Ur, Uu, Uu, Ur, Uu, Xue, Xue, Xue, Uu^Vu, Ur, Xue, Xue, Xue, Xue, Xue, Xue, Xue, Xue, Ur, Ur, Uu^Vu, Xue, Xue, Xue
Cud, Rr, Rr, Rr, Rr, Rr, Xos, Xos, Xuc, Xuc, Xue, Xue, Xue, Xue, Xue, Ur, Xue, Xue, Xue, Xue, Xue, Xue, Xue, Ur, Xue, Xue, Uu^Vu, Xue, Xue, Xue, Xue, Xue, Xue, Xue, Xue, Xue, Xue, Xue, Xue, Xue, Xue, Ur, Xue, Xue, Xue, Xue
Rr, Rr, Cud, Xos, Xos, Xos, Xuc, Xuc, Xuc, Xuc, Xuc, Xue, Xue, Xue, Xue, Xue, Xue, Xue, Xue, Xue, Xue, Xue, Xue, Xue, Xue, Xue, Xue, Xue, Xue, Xue, Xue, Xue, Xue, Xue, Xue, Xue, Xue, Xue, Xue, Xue, Xue, Xue, Xue, Xue, Xue, Xue
