Gg, Gg, Gg, Gg, Gg, Wo, Wo, Wo, Wo, Gg, Gg, Gg, Gg, Gg, Gg, Gg, Gg, Gg, Gg, Gg, Gg, Gg, Ww, Ww, Gg, Gg, Gs^Fdw, Gs^Fdw, Gs^Fdw, Gs^Fdw, Gs^Fdw, Gs^Fdw, Gs^Fdw, Gs^Fdw, Gs^Fp, Gs^Fp, Gs^Fp, Ww, Gs^Fp, Gs^Fp, Gs^Fp, Gs^Fp, Gs^Fp, Gs^Fp, Gs^Fp, Gs^Fp, Ww
Gg, Gg, Gg, Gg, Re, Re, Ss, Wo, Ss, Ww, Ww, Gg, Gg, Gg, Gg, Gg, Gg, Gg, Gg, Gg, Gg, Gg, Gg, Ww, Ww, Ww, Ww, Ww, Ww, Ww, Ww, Gs^Fdw, Gs^Fdw, Gs^Fp, Ww, Gs^Fp, Gs^Fp, Gs^Fp, Gs^Fp, Ww, Gs^Fp, Gs^Fp, Gs^Fp, Gs^Fp, Ww, Ww, Gs^Fp
Gg, Gg, Re, Re, Ss, Ss, Ss, Ss, Ss, Ss^Vhs, Ww, Gg, Gg, Gg, Gg, Gg, Gg, Gg, Gg, Gg, Gg, Gg, Gg, Gg, Gs^Fdw, Ww, Gs^Fdw, Gs^Fdw, Gs^Fdw, Ww, Gs^Fdw, Ww, Ww, Gs^Fp, Ww, Ww, Ww, Gs^Fp, Ww, Gs^Fp, Ww, Gs^Fp, Ww, Ww, Gs^Fp, Gs^Fp, Gs^Fp
Gg, Gg, Re, Ss^Vhs, Ss, Ss, Ss, Ss, Ss, Ss, Ss, Ww^Bw|, Ww, Gg, Co, Gg, Gg, Gg, Gg, Gg, Gg, Gg, Gg, Gg, Gs^Fdw, Gs^Fdw, Gs^Fdw, Gs^Fdw, Gs^Fdw, Gs^Fdw, Gs^Fdw, Ww, Ww, Ww, Wo, Ww, Wo, Ww, Wo, Ww, Ww, Ww, Ww, Gs^Fp, Gs^Fp, Gs^Fp, Gs^Fp
Re, Re, Ss, Ss, Ss, Ss, Ss, Ss, Ss, Ss, Ss, Re, Co, Wwf, Wwf, Co, Co, Gg, Gg, Gg, Gg, Gg, Gg, Gg, Gs^Fdw, Gs^Fdw, Gs^Fdw, Gs^Fdw, Gs^Fdw, Gs^Fdw, Gs^Fdw, Gs^Fdw, Ww, Ww, Ww, Gg^Ve, Wo, Wo, Wo, Wo, Ww, Ww, Ww, Ww, Gs^Fp, Gs^Fp, Gs^Fp
Ss, Ss^Vhs, Ss, Ss, Ss, Ss, Ss, Ss, Ss, Ss, Ss, Re, Co, 5 Ko, Wwf, Wwf, Wwf, 4 Ko, Gg, Gg, Gg, Gg, Gg, Gg, Gs^Fdw, Gs^Fdw, Gs^Fdw, Gs^Fdw, Gs^Fdw, Gs^Fdw, Gs^Fdw, Gs^Fdw, Gs^Fdw, Ww, Wwf, Wwf, Ww, Wo, Ww, Ww^Bw\, Gg, Ww, Ww, Ww, Gs^Fp, Gs^Fp, Gs^Fp
Ss, Ss, Ss, Ss, Ss, Ss, Ss, Ss, Ss, Ss, Ss^Bw/, Re, Re, Co, Co, Wwf, Wwf, Co, Gg, Gg, Gg, Gg, Gg, Gg, Gg, Gs^Fdw, Gs^Fdw, Gs^Fdw, Gs^Fdw, Gs^Fdw, Gs^Fdw, Ww, Gs^Fdw, Ww, Gs^Fdw, Ww, Gs^Fp, Ww, Gs^Fp, Ww, Gs^Fp, Gs^Fp, Gs^Fp, Ww, Gs^Fp, Gs^Fp, Gs^Fp
Ss, Ss, Ss, Ss, Ss, Ss, Ss, Chs, 6 Khs, Ss^Bw/, Ss, Ss, Ss, Re, Re, Wwf, Ww, Co, Gg, Gg, Gg, Gg, Gg, Gg, Gg, Gg, Gg, Gs^Fdw, Gg, Gg, Gs^Fdw, Gs^Fdw, Gs^Fdw, Gs^Fdw, Gs^Fdw, Gs^Fdw, Gs^Fp, Ww, Gs^Fp, Ww, Gs^Fp, Gs^Fp, Gs^Fp, Gs^Fp, Gs^Fp, Gs^Fp, Gs^Fp
Ss, Ss, Ss, Ss, Ss, Ss, Ss, Chs, Chs, Chs, Ss, Ss, Ss, Ss, Ss, Ww^Bw\, Ww^Bw\, Gg, Gg, Gg, Gg, Gg, Gg, Gg, Gg, Gg, Gg, Gg, Gg, Gg, Gs^Fdw, Gs^Fdw, Gs^Fdw, Gs^Fdw, Gs^Fdw, Gs^Fdw, Gs^Fdw, Gs^Fp, Gs^Fp, Gs^Fp, Gs^Fp, Gs^Fp, Gs^Fp, Gs^Fp, Gs^Fp, Gs^Fp, Gs^Fp
Ss, Ss, Ss, Ss, Ss, Ss, Ss, Ss, Ss, Ss, Ss, Ss, Ss, Ss, Ss, Ww, Ww, Gg, Gg, Gg, Gg, Gg, Gg, Gg, Gg, Gg, Gg, Gg, Gg, Gs^Fdw, Gs^Fdw, Gs^Fdw, Gs^Fdw, Gs^Fdw, Gs^Fdw, Gs^Fdw, Gs^Fdw, Gs^Fp, Gs^Fp, Gs^Fp, Gs^Fp, Gs^Fp, Gs^Fp, Gs^Fp, Gs^Fp, Gs^Fp, Gs^Fp
Ss, Ss, Ss, Ss, Ss, Ss, Ss, Ss, Ss, Ss, Ss, Ss, Ss, Ss, Ss^Vhs, Ww, Ww, Gg, Gg, Gg, Gg, Gg, Gg, Gg, Gg, Gg, Gg, Gg, Gg, Gs^Fdw, Gs^Fdw, Gs^Fdw, Gs^Fdw, Gs^Fdw, Gs^Fdw, Gs^Fdw, Gs^Fdw, Gs^Fp, Gs^Fp, Gs^Fp, Gs^Fp, Gs^Fp, Gs^Fp, Gs^Fp, Gg^Ve, Gs^Fp, Gs^Fp
Ss, Ss, Ss, Ss, Ss, Ss, Ss, Ss, Ss, Ss, Ss, Ss, Ss, Ss, Ss, Ww, Ww, Ww, Gg, Gg, Gg, Gg, Gg, Gg, Gg, Gg, Gg, Gg, Gg, Gs^Fdw, Gs^Fdw, Gs^Fdw, Gs^Fdw, Gs^Fdw, Gs^Fdw, Gs^Fdw, Gs^Fdw, Gs^Fp, Gs^Fp, Gs^Fp, Gg^Ve, Gs^Fp, Gs^Fp, Gs^Fp, Gs^Fp, Gs^Fp, Gs^Fp
Ss, Ss, Ss, Ss, Ss, Ss, Ss, Ss, Ss, Ss, Ss, Ss, Ss, Ss, Ss, Ww, Ww, Ww, Gg, Gg, Gg, Gg, Gg, Gg^Wm, Gg, Gg, Cv, Gg, Cv, Gg, Gs^Fdw, Gs^Fdw, Gs^Fdw, Gs^Fdw, Gs^Fdw, Gs^Fdw, Gs^Fdw, Kv, Gs^Fp, Gs^Fp, Gs^Fp, Gs^Fp, Gs^Fdw, Gs^Fp, Gs^Fp, Gs^Fp, Gs^Fp
Ss, Ss, Ss, Ss, Ss, Ss, Ss, Ss, Ss, Ss, Ss, Ss, Ss, Ss, Ss, Ww, Ww, Ww, Ww, Gg, Gg, Gg, Gg, Gg, Gg, Gg, Cv, Cv, Cv^Dr, Gs^Fdw, Rp, Gs^Fdw, Rp, Gs^Fdw, Rp, Rp, Rp, Rp, Rp, Rp, Rp, Rp, Gs^Fp, Rp, Rp, Rp, Rp
Ss, Ss, Ss, Ss, Ss, Ss, Ss, Ss, Ss, Ss, Ss, Ss, Ss, Ss, Ss, Ss, Ww, Ww, Ww, Gg, Gg, Gg, Re^Gvs, Gg, Gg, Gg, Cv, 2 Kv, Cv^Dr, Rp, Gs^Fdw, Rp, Gs^Fdw, Rp, Gs^Fdw, Gs^Fdw, Gs^Fdw, Kv, Gs^Fp, Gs^Fp, Gs^Fp, Gs^Fp, Gs^Fp, Gs^Fp, Gs^Fp, Gs^Fp, Gs^Fp
Gg, Ss, Ss, Ss, Ss, Ss, Ss, Ss, Ss, Ss, Ss, Ss, Ss, Ss, Gg, Gg, Gg, Ww, Gg, Ww, Re^Gvs, Re^Gvs, Re^Gvs, Re^Gvs, Re^Gvs, Gg, Gg, Cv^Dr, Gs^Fdw, Gs^Fdw, Gs^Fdw, Gs^Fdw, Gs^Fdw, Gs^Fdw, Gs^Fdw, Gs^Fdw, Gs^Fp, Gs^Fp, Gg^Ve, Gs^Fp, Gs^Fp, Gs^Fp, Gs^Fp, Gs^Fp, Gs^Fp, Gs^Fp, Gs^Fp
Gg, Gg, Gg, Gg, Gg, Gg, Gg, Ss, Gg, Ss, Ss^Vhs, Ss, Gg, Gg, Gg, Gg^Vo, Gg, Gg, Ww, Ww, Ww, Re^Gvs, Re^Gvs, Re^Gvs, Gg, Gg, Gg, Gg, Gg, Gs^Fdw, Gs^Fdw, Gs^Fdw, Gs^Fdw, Gs^Fdw, Gs^Fdw, Gs^Fdw, Gs^Fp, Gs^Fp, Gs^Fp, Gs^Fp, Gs^Fp, Gs^Fp, Gs^Fp, Gs^Fp, Gs^Fp, Gs^Fp, Gs^Fp
Gg, Gg, Gg, Gg, Gg, Gg, Gg, Gg, Gg, Gg, Gg, Gg, Gg, Gg, Gg, Gg, Gg, Gg, Gg, Ww, Ww, Ww, Ww, Ww, Ww, Gg, Gg, Gg, Ww, Gs^Fdw, Ww, Ww, Ww, Gs^Fdw, Ww, Ww, Ww, Gs^Fp, Ww, Gs^Fp, Ww, Ww, Ww, Gg^Ve, Ww, Ww, Ww
Gg, Gg, Gg, Gg, Gg, Gg, Gg, Gg, Gg, Gg, Gg, Gg, Co, Co, Co, Gg, Gg, Gg, Gg^Vo, Gg, Gg, Ww, Ww, Ww, Ww, Ww, Ww, Ww, Gg, Ww, Gs^Fdw, Gs^Fdw, Gs^Fdw, Ww, Gs^Fdw, Gs^Fdw, Gs^Fp, Ww, Gs^Fp, Ww, Gs^Fp, Gs^Fp, Gs^Fp, Ww, Gs^Fp, Gs^Fp, Gs^Fp
Gg, Gg, Gg, Gg, Gg, Gg, Gg, Gg, Gg, Gg, Gg, Gg, Co, 3 Ko, Co, Gg, Gg, Gg, Gg, Hh, Hh, Hh, Hh, Hh, Hhd^Vhhr, Ww, Ww, Ww, Ww, Gg^Dr, Hh^Fds, Gs^Fdw, Hh^Fds, Gs^Fdw, Hh^Fds, Gs^Fdw, Hh^Fds, Gs^Fp, Gs^Fp, Gs^Fp, Hh^Fds, Gs^Fp, Gs^Fp, Gs^Fp, Gs^Fp, Gs^Fp, Gs^Fp
Gg, Gg, Gg, Gg, Gg, Gg, Gg, Gg, Gg^Vo, Gg, Dd, Gg, Dd, Co, Dd, Dd, Hh, Gg, Hh, Mm, Mm, Mm, Mm, Mm, Mm, Mm, Ww, Ww, Ww, Ww, Mm, Hh^Fds, Hh^Fds, Hh^Fds, Hh^Fds, Hh^Fds, Hh^Fds, Hh^Fds, Hh^Fds, Hh^Fds, Hh^Fds, Hh^Fds, Hh^Fds, Gs^Fp, Gs^Fp, Gs^Fp, Gs^Fp
Gg, Gg, Dd, Gg, Dd, Dd, Dd, Dd, Dd, Dd, Dd, Dd, Dd, Dd, Hd, Hd, Mm, Hhd^Vhhr, Hh, Hh, Hh, Mm, Xu, Mm, Mm, Mm, Mm, Ww, Ww, Ww, Ww, Mm, Mm, Hh^Fds, Mm, Hh^Fds, Hh^Fds, Hh^Fds, Hh^Fds, Hh^Fds, Hh^Fds, Hh^Fds, Hh^Fds, Hh^Fds, Hh^Fds, Hh^Fds, Hh^Fds
Dd, Dd, Dd, Dd, Dd, Dd, Dd, Dd, Dd, Dd, Hd, Dd, Hd, Hd, Hd, Hd, Mm, Mm, Mm, Hh, Hh^Ii, Hh^Ii, Uu^Ii, Xu, Xu, Mm, Xu, Mm, Mm, Mm, Mm, Ww, Ww, Mm, Mm, Mm, Mm, Hh^Fds, Mm, Mm, Mm, Hh^Fds, Hh^Fds, Hh^Fds, Hh^Fds, Hh^Fds, Hh^Fds
Dd, Dd, Dd, Dd, Dd, Dd, Dd, Dd, Dd^Vdt, Dd, Hd, Hh, Hd, Hd, Mm, Mm, Mm, Mm, Mm, Xu, Xu, Uu^Ii, Tb^Tf, Ur, Tb^Tf, Xu, Xu, Mm, Mm, Mm, Mm, Mm, Mm, Ww, Ww, Mm, Mm, Mm, Mm, Mm, Mm, Mm, Mm, Hh^Fds, Hh^Fds, Hh^Fds, Hh^Fds
Dd, Dd, Gs^Ft, Dd, Dd, Dd, Dd, Dd, Dd, Hd, Hd, Hh, Hd, Hd, Mm, Mm, Mm, Mm, Mm, Mm, Xu, Uu^Vu, Uh, Tb^Tf, Uh, Tb^Tf, Uu, Xu, Mm, Mm, Mm, Mm, Mm, Mm, Mm, Ww, Ww, Mm, Mm, Mm, Mm, Mm, Mm, Mm, Mm, Mm, Mm
Dd, Ww, Ww, Gg, Ww, Dd, Dd, Dd, Hh, Hh, Hh, Hh, Mm, Mm, Mm, Mm, Mm, Mm, Mm, Mm^Xm, Mm^Xm, Xu, Xu, Ur, Uu, Ur, Tb^Tf, Xu, Xu, Mm, Mm, Mm, Mm, Mm, Mm, Ww, Ww, Mm, Mm, Mm, Mm, Mm, Mm, Mm, Mm, Mm, Mm
Dd, Ww, Ww, Ww, Ww, Dd, Dd, Hd, Hh, Hh, Mm, Mm, Mm, Mm, Mm, Mm, Mm, Mm, Mm, Mm^Xm, Mm^Xm, Mm^Xm, Mm^Xm, Xu, Xu, Ur, Tb^Tf, Uu^Vud, Xu, Mm, Mm, Mm, Mm, Mm, Mm, Mm, Ww, Mm, Mm, Mm, Mm, Mm, Mm, Mm, Mm, Mm, Mm
Dd, Dd, Dd, Ww, Dd, Dd, Hd, Hh, Hd, Hd, Mm, Mm, Mm, Mm, Mm, Mm, Mm, Mm, Mm, Mm^Xm, Mm^Xm, Mm^Xm, Mm^Xm, Mm^Xm, Xu, Xu, Ur, Ur, Xu, Mm, Mm, Mm, Mm, Mm, Ai, Ww, Mm, Mm, Mm, Mm, Mm, Mm, Mm, Mm, Mm, Mm, Mm
Dd, Dd, Dd, Dd, Dd, Dd, Hd, Hh, Hd, Mm, Mm, Mm, Mm, Mm, Mm, Mm, Mm, Mm, Mm^Xm, Mm^Xm, Mm^Xm, Mm^Xm, Mm^Xm, Mm^Xm, Xu, Xu, Uh^Dr, Xu, Xu, Xu, Xu, Xu, Xu, Mm, Mm, Ww, Ww, Mm, Ww, Mm, Ai, Mm, Mm, Mm, Mm, Mm, Mm
Dd, Dd, Dd, Dd^Vdt, Hd, Hd, Hd, Hh, Hd, Mm, Mm, Mm, Mm, Mm, Mm, Mm, Mm, Mm, Mm^Xm, Mm^Xm, Mm^Xm, Mm^Xm, Mm^Xm, Mm^Xm, Xu, Qxu, Ha^Ii, Qxu, Ql, Ql, Ql, Ql, Qlf, Xu, Xu, Mm, Mm, Ww, Mm, Ww, Mm, Ww, Ww, Mm, Mm, Mm, Mm
Dd, Dd^Vdt, Hh, Hh, Hd, Hd, Hh, Hh, Hd, Mm, Mm, Mm, Mm, Mm, Mm, Mm, Mm^Xm, Mm^Xm, Mm^Xm, Mm^Xm, Mm^Xm, Mm^Xm, Mm^Xm, Mm^Xm, Xu, Ql, Ql, Ha^Ii, Uu^Ii, Ql, Ql, Qlf, Mm^Xm, Qlf, Qlf, Xu, Xu, Xu, Mm, Mm, Mm^Xm, Mm, Mm, Ww, Mm, Mm, Mm
Hd, Hd, Hh, Hd, Hh, Hd, Dd, Hh, Mm, Mm, Mm, Mm, Mm, Mm, Mm^Xm, Mm^Xm, Mm^Xm, Mm^Xm, Mm^Xm, Mm^Xm, Mm^Xm, Mm^Xm, Mm^Xm, Mm^Xm, Xu, Ql, Ql, Ql, Ql, Ql^Bs\, Ql^Bs\, Mm^Xm, Gd^Efm, Mm^Xm, Mm^Xm, Qlf, Qlf, Xu, Xu, Mm^Xm, Mm^Xm, Mm^Xm, Mm^Xm, Ai, Mm^Xm, Mm, Mm
Hd, Hh, Hh, Hh, Hh, Dd^Vdt, Hd, Hd, Mm, Mm, Mm, Mm, Mm^Xm, Mm^Xm, Mm^Xm, Mm^Xm, Mm^Xm, Mm^Xm, Mm^Xm, Mm^Xm, Mm^Xm, Mm^Xm, Mm^Xm, Mm^Xm, Xu, Ql, Ql, Ql, Ql, Ql, Mm, Gd^Efm, 1 Gg^Fet, Gd^Efm, Mm^Xm, Qlf, Qlf, Qlf, Xu, Mm^Xm, Mm^Xm, Mm^Xm, Mm^Xm, Wo, Mm^Xm, Mm^Xm, Mm^Xm
Hh, Hh, Hd, Hh, Hd, Hd, Mm, Mm, Mm, Mm, Mm, Mm^Xm, Mm^Xm, Mm^Xm, Mm^Xm, Mm^Xm, Mm^Xm, Mm^Xm, Mm^Xm, Mm^Xm, Mm^Xm, Mm^Xm, Mm^Xm, Xu, Xu, Qlf, Qlf, Qlf, Qlf, Qlf, Mm^Xm, Gd^Efm, Gd^Efm, Gd^Efm, Mm^Xm, Qlf, Qlf, Qlf, Xu, Mm^Xm, Mm^Xm, Mm^Xm, Chw^Dr, Wo, Mm^Xm, Mm^Xm, Mm^Xm
Hh, Hd, Hh, Hh, Hd, Mm, Mm, Mm, Mm, Mm^Xm, Mm^Xm, Mm^Xm, Mm^Xm, Mm^Xm, Mm^Xm, Mm^Xm, Mm^Xm, Mm^Xm, Mm^Xm, Mm^Xm, Mm^Xm, Mm^Xm, Mm^Xm, Xu, Qlf, Qlf, Qlf, Qlf, Qlf, Qlf, Qlf, Mm^Xm, Mm^Xm, Mm^Xm, Qlf, Qlf, Qlf, Xu, Mm^Xm, Mm^Xm, Wo, Wo, Wo, Mm^Xm, Mm^Xm, Mm^Xm, Mm^Xm
Hh, Hh, Hd, Hd, Mm, Mm, Mm, Mm, Mm^Xm, Mm^Xm, Mm^Xm, Mm^Xm, Mm^Xm, Mm^Xm, Mm^Xm, Mm^Xm, Mm^Xm, Mm^Xm, Mm^Xm, Mm^Xm, Mm^Xm, Mm^Xm, Mm^Xm, Xu, Xu, Qlf, Qlf, Qlf, Qlf, Qlf, Qlf, Qlf, Qlf, Qlf, Qlf, Qlf, Qlf, Xu, Mm^Xm, Mm^Xm, Mm^Xm, Wo, Mm^Xm, Mm^Xm, Mm^Xm, Mm^Xm, Mm^Xm
Hd, Hd, Mm, Mm, Mm, Mm, Mm, Mm, Mm^Xm, Mm^Xm, Mm^Xm, Mm^Xm, Mm^Xm, Mm^Xm, Mm^Xm, Mm^Xm, Mm^Xm, Mm^Xm, Mm^Xm, Mm^Xm, Mm^Xm, Mm^Xm, Mm^Xm, Mm^Xm, Xu, Qlf, Qlf, Qlf, Qlf, Qlf, Qlf, Qlf, Qlf, Qlf, Qlf, Qlf, Xu, Xu, Mm, Mm^Xm, Mm, Mm^Xm, Mm^Xm, Mm^Xm, Mm^Xm, Mm^Xm, Mm^Xm
