Gs^Fmf, Gs^Fmf, Gs^Fmf, Gg, Gg, Rp, Gg, Gg, Gg, Gg, Gg, Gg, Gg, Gg, Gg, Gg, Gg, Gg, Gs^Fmf, Gg, Gs^Fmf, Gg, Gs^Fmf, Gg, Gs^Fmf, Gg, Gs^Fmf, Gs^Fmf, Gs^Fmf, Gg, Gg, Gg, Hh, Mm^Xm, Ss, Ss, Ss, Ss, Ss, Ss, Ss, Ss, Gg, Gg, Gg, Gg
Gs^Fmf, Gs^Fmf, Gs^Fmf, Gg, Gg, Rp, Rp, Gg, Gg, Gg, Gg, Gg^Ve, Gg, Gg, Cv, Gg, Gg, Gs^Fmf, Gg^Ve, Gs^Fmf, Gs^Fmf, Gs^Fmf, Gs^Fmf, Gs^Fmf, Gs^Fmf, Gs^Fmf, Gs^Fmf, Gs^Fmf, Gg, Gg, Gg, Gg, Hh, Mm^Xm, Mm^Xm, Ss, Ss, Ss, Ss, Ss, Ss, Ss, Co, Gg, Gg, Gg
Gs^Fmf, Gs^Fmf, Gs^Fmf, Gs^Fmf, Gs^Fmf, Gg, Gg, Rp, Rp, Gg, Rp, Gg, Cv, Cv, 1 Kv, Cv, Cv, Gs^Fmf, Gs^Fmf, Gs^Fmf, Gs^Fmf, Gs^Fmf, Gs^Fmf, Gs^Fmf, Gs^Fmf, Gs^Fmf, Gg, Gg, Gg, Gg, Gg, Gg, Gg, Hh, Mm^Xm, Ss, Ss, Ss, Ss, Ss, Co, Co, Co, Co, Co, Gg
Gs^Fmf, Gs^Fmf, Gs^Fmf, Gs^Fmf, Gs^Fmf, Gs^Fmf, Gg, Gg, Gg, Rp, Gg, Rp, Re, Cv, Cv, Cv, Gg, Gs^Fmf, Gs^Fmf, Gs^Fmf, Gs^Fmf, Gs^Fmf, Gs^Fmf, Gs^Fmf, Gg, Gg, Gg, Gg, Gg, Gg, Gg, Gg, Gg, Hh, Mm^Xm, Mm^Xm, Ss, Ss, Ss, Gg, Co, Co, 2 Ko, Co, Co, Gg
Gs^Fmf, Gs^Fmf, Gs^Fmf, Gs^Fmf, Gs^Fmf, Gs^Fmf, Gs^Fmf, Gs^Fmf, Gs^Fmf, Gg, Gs^Fmf, Gg, Gg, Re, Re, Gg, Gg, Gs^Fmf, Gs^Fmf, Gs^Fmf, Gs^Fmf, Gs^Fmf, Gs^Fmf, Gs^Fmf, Gg, Gg, Gg, Gg, Gg, Gg, Gg, Gg, Hh, Hh, Mm^Xm, Ss, Ss, Ss, Ss, Gg, Co, Co, Co, Co, Co, Gg
Gs^Fmf, Gs^Fmf, Gs^Fmf, Gs^Fmf, Gs^Fmf, Gs^Fmf, Gs^Fmf, Gs^Fmf, Gs^Fmf, Gs^Fmf, Gg, Re^Vct, Gg, Gg, Re, Gg, Re^Vct, Gg, Gg, Gg, Gg, Gg, Gg, Gg, Gg, Gg, Gg, Gg, Gg, Gg, Hh, Hh, Mm, Mm, Mm^Xm, Ss, Ss, Ss, Gg, Gg, Gg, Co, Co, Co, Gg, Gg
Hh, Gg, Gg, Gg, Gg, Gs^Fmf, Gg, Gs^Fmf, Gg, Gg, Gg, Gg, Gg, Gg, Re^Vct, Re, Re, Gg, Gg, Gg, Gg, Gg, Gg, Gg, Gg, Gg, Gg, Gg, Gg, Hh, Mm, Mm, Ss, Ss, Ss, Ss, Ss, Ss, Gg, Re^Vct, Gg, Gg, Gg, Gg, Re^Vct, Gg
Mm^Xm, Hh, Hh, Gg, Gg, Gg, Gg, Gg, Gg, Gg, Gg, Gg, Gg, Gg, Gg, Gg, Re, Re, Gg, Gg, Gg, Gg, Gg, Gg, Gg, Gg, Hh, Hh, Hh, Hh, Mm^Xm, Ss, Ss^Vhs, Ss, Ss, Ss, Gg, Gg, Gg, Gg, Gg, Gg, Gg, Gg, Gg, Gg
Ss, Mm^Xm, Mm^Xm, Hh, Gg, Gg, Gg, Gg, Gg, Gg, Gg^Ve, Gg, Gg, Gg, Gg, Gg, Gg, Re, Re, Gg, Gg, Gg, Gg, Gg, Hh, Hh, Mm, Mm^Xm, Mm^Xm, Mm^Xm, Ss, Ss, Ss, Ss, Gg, Gg, Gg, Gg, Gg, Gg, Gg, Gg, Re^Vct, Gg, Gg, Gg
Ss, Mm^Xm, Mm^Xm, Hh, Hh, Gg, Gg, Gg, Gg, Gg, Gg, Gg, Gg, Gg, Gg, Gg, Gg, Gg, Re, Gg, Gg, Gg, Hh, Hh, Mm, Mm, Mm, Mm, Ss, Ss, Ss, Ss, Ss, Ss, Gg, Gg, Gg, Gg, Gg, Gg, Gg, Gg, Gg, Gg, Gg, Gg
Ss, Ss, Ss, Mm^Xm, Mm, Hh, Hh, Gg, Gg, Gg, Gg, Gg, Gg, Gg, Gg, Gg, Gg, Gg, Gg, Re, Re, Hh, Mm, Mm, Ss, Ss, Ss, Ss, Ss, Ss, Ss, Ss, Gg, Gg, Gg, Gg, Gll^Ftr, Gg, Gg, Gg, Gg, Gg, Gg, Gg, Gg, Gg
Ss, Ss, Ss^Vhs, Ss, Ss, Mm, Hh, Gg, Hh, Gg, Gg, Gg, Gg, Gg, Hh, Gg, Gg, Gg, Hh, Hh, Mm, Mm, Ss, Ss, Ss, Ss, Ss, Ss, Ss, Ss, Ss, Gg, Gg, Gll^Ftr, Gll^Ftr, Gll^Ftr, Gll^Ftr, Gg, Gg, Gg, Gg, Gg, Gg, Gg, Gg, Gg
Ss, Ss, Ss, Ss, Ss, Mm, Mm, Hh, Mm, Hh, Hh, Hh, Hh, Hh, Mm^Xm, Hh, Hh, Hh, Mm^Xm, Mm^Xm, Ss, Ss^Bw\r, Ss^Bw\r, Ss, Ss, Ss, Ss^Vhs, Ss, Ss, Ss, Ss, Gg, Gg, Gll^Ftr, Gll^Ftr, Gll^Ftr, Gll^Ftr, Gg, Gg, Gg, Gg, Gg, Gg, Gg, Gg, Gg
Gg, Ss, Ss, Ss, Ss, Ss, Ss, Mm, Ss, Mm, Mm^Xm, Mm^Xm, Mm^Xm, Mm^Xm, Ss, Mm^Xm, Mm^Xm, Mm^Xm, Ss, Ss, Ss, Ss, Ss, Re, Re, Ss, Ss, Ss, Ss, Ss, Ss, Ss, Ss, Gg, Gg, Gg, Gg, Gg, Gg, Gg, Gg, Gg, Gg, Gg, Gg, Gg
Gg, Gg, Gg, Ss, Ss, Ss, Ss, Ss, Ss, Ss, Ss, Ss, Ss, Ss, Ss, Ss, Ss, Mm^Xm, Ss, Ss, Ss, Ss, Chs, Ss, Ss, Ss^Bw\r, Ss^Bw\r, Ss, Ss, Ss, Ss, Ss, Ss, Ss, Ss, Ss, Ss, Ss, Ss, Gg, Sm, Gg, Gg^Dr, Gg, Gg, Gg
Gg, Gg, Gg, Gg, Gg, Ss, Ss, Ss, Ss, Ss, Ss, Ss, Ss, Ss, Ss, Ss, Ss, Ss, Ss, Ss, Chs, Chs, Chs, Chs, Chs, Ss, Ss, Re, Ss, Ss, Ss, Ss, Ss^Vhs, Ss, Ss, Ss, Ss, Ss, Ss, Sm, Sm, Sm, Sm, Sm, Sm, Gg
Gg, Gg, Gg, Gg, Gg, Gg, Gg, Ss, Gg, Ss, Gg, Ss, Gg, Ss, Gg, Ss, Ss, Ss^Vhs, Ss, Ss, Chs, Chs, 3 Khs, Chs, Chs, Ss, Ss, Re, Ss, Ss, Ss, Ss, Ss, Ss, Ss, Ss, Ss, Ss, Ss, Sm, Sm, Sm, Sm, Sm, Sm, Sm
Gg, Gg, Hh, Gg, Hh, Hh, Hh, Hh, Gg, Gg, Gll^Ftr, Gg, Gll^Ftr, Gg, Gg, Gg, Ss, Ss, Ss, Ss, Chs, Chs, Chs, Chs, Chs, Ss, Ss, Re, Ss, Ss, Ss, Ss, Ss, Ss, Re, Re, Re, Sm, Sm, Sm, Sm, Sm, Sm, Sm, Sm, Sm
Gg, Gg, Hh, Hh, Mm, Mm, Mm, Hh, Gg, Gg, Gll^Ftr, Gll^Ftr, Gll^Ftr, Gll^Ftr, Gg, Gg, Gg, Ss, Ss, Ss, Ss, Chs, Ss, Ss, Ss, Ss, Ss, Re, Re, Ss, Gs, Gs, Gs, Gd, Gd, Re, Re, Sm, Sm, Sm, Sm, Sm, Re, Re, Re, Re
Gg, Gg, Hh, Mm, Mm, Mm, Mm, Hh, Gg, Gg, Gll^Ftr, Gll^Ftr, Gg, Gg, Gg, Gg, Ss, Ss, Ss, Ss, Ss, Ss, Ss, Ss, Ss, Ss, Ss, Ss, Gs, Gs, Gs, Gs, Gs, Gd, Gd, Re, Re, Sm, Sm, Sm, Re, Re, Re, Hhd, Hhd, Hhd
Gg, Gg, Hh, Mm, Hh, Mm, Hh, Hh, Gg, Gg, Gg, Gg, Gg, Gg, Ss, Ss, Ss, Ss, Ss, Ss, Ss, Ss, Ss, Ss, Ss, Ss, Gs, Gs, Gs, Gs, Gs, Gs, Gd, Gd, Gd, Re, Re, Sm, Re, Sm, Re, Re, Hhd, Hhd, Hhd, Hhd
Gg, Gg, Hh, Hh, Hh, Hh, Gg, Gg, Gg, Gg, Gg, Gg, Ss, Ss, Ss, Ss, Ss, Ss, Ss, Ss, Ss, Ss, Ss, Ss, Gs, Gs, Gs, Gs, Gs, Gs, Gs, Gs, Gd, Gd, Gd, Re, Re, Re^Vu, Re, Re, Re, Hhd, Hhd, Hhd, Hhd, Hhd
Gg, Gg, Gg, Gg, Gg, Gg, Gg, Gg, Gg, Gg, Ss, Ss, Ss, Ss, Ss^Vhs, Ss, Ss, Gs, Gs, Gs, Gs, Ss, Gs, Gs, Gs, Gs, Gs, Gs, Gs, Gs, Gs, Gd, Gd, Gd, Re, Re, Re, Re, Re, Re^Dr, Hhd, Hhd, Hhd, Hhd, Hhd, Hhd
Gg, Gg, Gg, Gg, Gg, Gg, Gg, Gg, Ss, Ss, Ss, Ss, Ss, Ss, Ss, Ss, Gs, Gs, Gs, Gs, Gs, Gs, Gs, Gs, Gs, Gs, Gs, Gs, Gs, Gs, Gd, Gd, Re, Gd, Re^Dr, Re, Re, Re, Re, Re, Hhd, Hhd, Hhd, Hhd, Hhd, Hhd
Gg, Gg, Gg, Gg, Gg, Gg, Ss, Ss, Ss, Ss, Ss, Ss, Ss, Ss, Gs, Gs, Gs, Gs, Gs, Gs, Gs, Gs, Gs^Vu, Gs, Gs, Gs, Gs, Gs, Gs, Gd, Re, Re^Vu, Re, Re, Re, Re, Re, Re^Vu, Re, Hhd, Hhd, Hhd, Hhd, Hhd, Hhd, Hhd
Gg, Gg, Ss, Gg, Ss, Ss, Ss, Ss, Ss, Ss, Ss, Ss, Gg, Gg, Gg, Gs, Gs, Gs, Gs, Gs, Gs, Gs, Gs, Gs, Gs, Gs, Gd, Gd, Gd, Gd, Re, Re, Re, Re, Re, Re, Cfr, Cfr, Cfr, Hhd, Hhd, Hhd, Hhd, Hhd, Hhd^Dr, Hhd
Ss, Ss, Ss, Ss, Ss, Ss, Ss, Ss, Ss, Ss, Gg, Gg, Gg, Gg, Gg, Gg, Gs, Gs, Gs, Gs, Gs, Gs, Gs, Gs, Gs, Gs, Gd, Gd, Re, Re, Re, Re^Dr, Re, Re, Re, Cfr, Cfr, Cfr, Cfr, Cfr, Hhd, Hhd, Hhd, Hhd, Hhd, Hhd
Ss, Ss, Ss, Ss, Ss, Ss, Ss, Ss, Gg^Dr, Gg, Gg^Vo, Gg, Gg, Gg, Gg, Gg, Gg, Gs, Gs, Gs, Gs, Gs, Gs, Gs, Gs, Gd, Re, Re^Dr, Re, Re, Re, Re, Re, Re^Vu, Re, Cfr, Cfr, 4 Kfr, Cfr, Cfr, Hhd, Hhd, Hhd, Hhd, Hhd, Hhd
Ss, Ss, Ss, Ss, Gg, Gg, Gg, Gg, Gg, Gg, Gg, Gg, Gg, Gg, Gg, Gg, Gg, Gs, Gs, Gs, Gs, Gs, Gs, Gs, Gd, Gd, Re, Re, Re, Re^Vu, Re, Re, Re, Re, Re, Cfr, Cfr, Cfr, Cfr, Cfr, Hhd, Hhd, Hhd, Hhd, Ql, Ql
Ss, Ss, Ss, Gg, Co, Gg, Gg, Gg, Gg^Vo, Gg, Gg, Gg, Gg, Gg, Gg, Gg, Gg, Gg, Gg, Gs, Gs, Gs, Gs, Gs, Gd, Gd, Re, Re, Re, Re, Re, Re, Re, Re, Hhd, Hhd, Hhd, Cfr, Hhd, Hhd, Hhd, Hhd, Ql, Ql, Ql, Ql
Gg, Ss, Co, Co, Co, Co, Co, Gg, Gg, Gg, Gg^Dr, Gg, Gg, Gg, Gg, Gg, Gg, Gg, Gg, Gs, Gs, Gg^Dr, Gs, Gs, Gd, Gd, Hhd, Re, Hhd, Hhd, Hhd, Hhd, Hhd, Hhd, Hhd, Hhd, Hhd, Hhd, Hhd, Hhd, Ql, Ql^Bs\, Ur, Cud, Cud, Ql
Gg, Gg, Co, Co, 5 Ko, Co, Co, Gg, Gg, Gg, Gg, Gg, Gg, Gg, Gg, Gg, Gg, Gg, Gg, Gs, Gs, Gs, Gs, Gs, Hhd, Hhd, Hhd, Hhd, Hhd, Hhd, Hhd, Hhd, Hhd, Hhd, Hhd, Hhd, Hhd, Hhd, Ql, Ql, Cud, Ur, Ur, Ur, Uu, Cud
Gg, Gg, Co, Co, Co, Co, Co, Gg, Gg^Vo, Gg, Gg, Gg, Gg^Vo, Gg, Gg, Gg, Gg, Gg, Gg, Gs, Gs, Gs, Hhd, Hhd, Hhd, Hhd, Hhd, Hhd, Hhd, Hhd, Hhd^Dr, Hhd, Hhd, Hhd, Hhd, Hhd, Ql, Ql, Ql, Ql, Cud, Ur, Uu, Uu, Uu, Xu
Gg, Gg, Gg, Co, Co, Co, Gg, Gg, Gg, Gg, Gg^Dr, Gg, Gg, Gg, Gg, Gg, Gg, Gg, Gg, Gs, Hhd, Hhd, Hhd, Hhd, Hhd, Hhd, Hhd, Hhd, Hhd, Hhd, Hhd, Hhd, Hhd, Hhd, Ql, Ql, Ql, Ql, Ql, Ql, Cud, Uu, Uu, Uu, Uu, Uu
Gg, Gg, Gg, Gg, Gg, Gg, Gg, Gg, Gg, Gg, Gg, Gg, Gg, Gg, Gg, Gg, Gg, Gg, Gg, Hhd, Hhd, Hhd, Hhd, Hhd, Hhd, Hhd, Hhd, Hhd, Hhd, Hhd, Hhd, Hhd, Ql, Ql, Ql, Ql, Ql, Ql, Ql, Ql, Cud, Xu, Xu, Uu, Uu, Uu
