Gs^Fmf, Gs^Fmf, Gs^Fmf, Gg, Gg, Rp, Gg, Gg, Gg, Gg, Gg, Gg, Gg, Gg, Gg, Gg, Gg, Gg, Gs^Fmf, Gg, Gs^Fmf, Gg, Gs^Fmf, Gg, Gs^Fmf, Gg, Gs^Fmf, Gs^Fmf, Gs^Fmf, Gg, Gg, Gg, Hh, Mm^Xm, Ss, Ss, Ss, Ss, Ss, Ss, Ss, Ss, Gg, Gg, Gg, Gg
Gs^Fmf, Gs^Fmf, Gs^Fmf, Gg, Gg, Rp, Rp, Gg, Gg, Gg, Gg, Gg^Ve, Gg, Gg, Gg^Efm, Gg, Gg, Gs^Fmf, Gg^Ve, Gs^Fmf, Gs^Fmf, Gs^Fmf, Gs^Fmf, Gs^Fmf, Gs^Fmf, Gs^Fmf, Gs^Fmf, Gs^Fmf, Gg, Gg, Gg, Gg, Hh, Mm^Xm, Mm^Xm, Ss, Ss, Ss, Ss, Ss, Ss, Ss, Co, Gg, Gg, Gg
Gs^Fmf, Gs^Fmf, Gs^Fmf, Gs^Fmf, Gs^Fmf, Gg, Gg, Rp, Rp, Gg, Rp, Gg, Gg, Gg^Efm, 1 Kv, Gg^Efm, Gg, Gs^Fmf, Gs^Fmf, Gs^Fmf, Gs^Fmf, Gs^Fmf, Gs^Fmf, Gs^Fmf, Gs^Fmf, Gs^Fmf, Gg, Gg, Gg, Gg, Gg, Gg, Gg, Hh, Mm^Xm, Ss, Ss, Ss, Ss, Ss, Co, Co, Co, Co, Co, Gg
Gs^Fmf, Gs^Fmf, Gs^Fmf, Gs^Fmf, Gs^Fmf, Gs^Fmf, Gg, Gg, Gg, Rp, Gg, Rp, Gg, Cv, Cv, Cv, Gg, Gs^Fmf, Gs^Fmf, Gs^Fmf, Gs^Fmf, Gs^Fmf, Gs^Fmf, Gs^Fmf, Gg, Gg, Gg, Gg, Gg, Gg, Gg, Gg, Gg, Hh, Mm^Xm, Mm^Xm, Ss, Ss, Ss, Gg, Co, Co, 2 Ko, Co, Co, Gg
Gs^Fmf, Gs^Fmf, Gs^Fmf, Gs^Fmf, Gs^Fmf, Gs^Fmf, Gs^Fmf, Gs^Fmf, Gs^Fmf, Gg, Gs^Fmf, Gg, Gg, Gg, Gg, Gg, Gg, Gs^Fmf, Gs^Fmf, Gs^Fmf, Gs^Fmf, Gs^Fmf, Gs^Fmf, Gs^Fmf, Gg, Gg, Gg, Gg, Gg, Gg, Gg, Gg, Hh, Hh, Mm^Xm, Ss, Ss, Ss, Ss, Gg, Co, Co, Co, Co, Co, Gg
Gs^Fmf, Gs^Fmf, Gs^Fmf, Gs^Fmf, Gs^Fmf, Gs^Fmf, Gs^Fmf, Gs^Fmf, Gs^Fmf, Gs^Fmf, Gg, Re^Vct, Gg, Gg, Gg, Gg, Re^Vct, Gg, Gg, Gg, Gg, Gg, Gg, Gg, Gg, Gg, Gg, Gg, Gg, Gg, Hh, Hh, Mm, Mm, Mm^Xm, Ss, Ss, Ss, Gg, Gg, Gg, Co, Co, Co, Gg, Gg
Hh, Gg, Gg, Gg, Gg, Gs^Fmf, Gg, Gs^Fmf, Gg, Gg, Gg, Gg, Gg, Gg, Re^Vct, Gg, Gg, Gg, Gg, Gg, Gg, Gg, Gg, Gg, Gg, Gg, Gg, Gg, Gg, Hh, Mm, Mm, Ss, Ss, Ss, Ss, Ss, Ss, Gg, Re^Vct, Gg, Gg, Gg, Gg, Re^Vct, Gg
Mm^Xm, Hh, Hh, Gg, Gg, Gg, Gg, Gg, Gg, Gg, Gg, Gg, Gg, Gg, Gg, Gg, Gg, Gg, Gg, Gg, Gg, Gg, Gg, Gg, Gg, Gg, Hh, Hh, Hh, Hh, Mm^Xm, Ss, Ss, Ss, Ss, Ss, Gg, Gg, Gg, Gg, Gg, Gg, Gg, Gg, Gg, Gg
Ss, Mm^Xm, Mm^Xm, Hh, Gg, Gg, Gg, Gg, Gg, Gg, Gg, Gg, Gg, Gg, Gg, Gg, Gg, Gg, Gg, Gg, Gg, Gg, Gg, Gg, Hh, Hh, Mm, Mm^Xm, Mm^Xm, Mm^Xm, Ss, Ss, Ss, Ss, Gg, Gg, Gg, Gg, Gg, Gg, Gg, Gg, Re^Vct, Gg, Gg, Gg
Ss, Mm^Xm, Mm^Xm, Hh, Hh, Gg, Gg, Gg, Gg, Gg, Gg, Gg, Gg, Gg, Gg, Gg, Gg, Gg, Gg, Gg, Gg, Gg, Hh, Hh, Mm, Mm, Mm, Mm, Ss, Ss, Ss, Ss, Ss, Ss, Gg, Gg, Gg, Gg, Gg, Gg, Gg, Gg, Gg, Gg, Gg, Gg
Ss, Ss, Ss, Mm^Xm, Mm, Hh, Hh, Gg, Gg, Gg, Gg, Gg, Gg, Gg, Gg, Gg, Gg, Gg, Gg, Gg, Hh, Hh, Mm, Mm, Ss, Ss, Ss, Ss, Ss, Ss, Ss, Ss, Gg, Gg, Gg, Gg, Gg, Gg, Gg, Gg, Gg, Gg, Gg, Gg, Gg, Gg
Ss, Ss, Ss, Ss, Ss, Mm, Hh, Gg, Hh, Gg, Gg, Gg, Gg, Gg, Hh, Gg, Gg, Gg, Hh, Hh, Mm, Mm, Ss, Ss, Ss, Ss, Ss, Ss, Ss, Ss, Ss, Gg, Gg, Gg, Gg, Gg, Gg, Gg, Gg, Gg, Gg, Gg, Gg, Gg, Gg, Gg
Ss, Ss, Ss, Ss, Ss, Mm, Mm, Hh, Mm, Hh, Hh, Hh, Hh, Hh, Mm^Xm, Hh, Hh, Hh, Mm^Xm, Mm^Xm, Ss, Ss, Ss, Ss, Ss, Ss, Ss, Ss, Ss, Ss, Ss, Gg, Gg, Gg, Gg, Gg, Gg, Gg, Gg, Gg, Gg, Gg, Gg, Gg, Gg, Gg
Gg, Ss, Ss, Ss, Ss, Ss, Ss, Mm, Ss, Mm, Mm^Xm, Mm^Xm, Mm^Xm, Mm^Xm, Ss, Mm^Xm, Mm^Xm, Mm^Xm, Ss, Ss, Ss, Ss, Ss, Ss, Ss, Ss, Ss, Ss, Ss, Ss, Ss, Ss, Ss, Gg, Gg, Gg, Gg, Gg, Gg, Gg, Gg, Gg, Gg, Gg, Gg, Gg
Gg, Gg, Gg, Ss, Ss, Ss, Ss, Ss, Ss, Ss, Ss, Ss, Ss, Ss, Ss, Ss, Ss, Mm^Xm, Ss, Ss, Ss, Ss, Chs, Ss, Ss, Ss, Ss, Ss, Ss, Ss, Ss, Ss, Ss, Ss, Ss, Ss, Ss, Ss, Ss, Gg, Ss, Gg, Gg^Dr, Gg, Gg, Gg
Gg, Gg, Gg, Gg, Gg, Ss, Ss, Ss, Ss, Ss, Ss, Ss, Ss, Ss, Ss, Ss, Ss, Ss, Ss, Ss, Chs, Chs, Chs, Chs, Chs, Ss, Ss, Ss, Ss, Ss, Ss, Ss, Ss, Ss, Ss, Ss, Ss, Ss, Ss, Ss, Ss, Ss, Ss, Ss, Ss, Gg
Gg, Gg, Gg, Gg, Gg, Gg, Gg, Ss, Gg, Ss, Gg, Ss, Gg, Ss, Gg, Ss, Ss, Ss, Ss, Ss, Chs, Chs, 3 Khs, Chs, Chs, Ss, Ss, Ss, Ss, Ss, Ss, Ss, Ss, Ss, Ss, Ss, Ss, Ss, Ss, Ss, Ss, Ss, Ss, Ss, Ss, Ss
Gg, Gg, Gg, Gg, Gg, Gg, Gg, Gg, Gg, Gg, Gg, Gg, Gg, Gg, Gg, Gg, Ss, Ss, Ss, Ss, Chs, Chs, Chs, Chs, Chs, Ss, Ss, Ss, Ss, Ss, Ss, Ss, Ss, Ss, Gg, Gg, Gg, Gg, Gg, Ss, Gg, Ss, Ss, Ss, Ss, Ss
Gg, Gg, Gg, Gg, Gg, Gg, Gg, Gg, Gg, Gg, Gg, Gg, Gg, Gg, Gg, Gg, Gg, Ss, Ss, Ss, Ss, Chs, Ss, Ss, Ss, Ss, Ss, Ss, Ss, Ss, Gg, Gg, Gg, Gg, Gg, Gg, Gg, Gg, Gg, Gg, Gg, Gg^Dr, Gg, Gg, Gg, Gg
Gg, Gg, Gg, Gg, Gg, Gg, Gg, Gg, Gg, Gg, Gg, Gg, Gg, Gg, Gg, Gg, Ss, Ss, Ss, Ss, Ss, Ss, Ss, Ss, Ss, Ss, Ss, Ss, Gg, Gg, Gg, Gg, Gg, Gg, Gg, Gg, Gg, Gg, Gg, Gg, Gg, Gg, Gg, Hh, Hh, Hh
Gg, Gg, Gg, Gg, Gg, Gg, Gg, Gg, Gg, Gg, Gg, Gg, Gg, Gg, Ss, Ss, Ss, Ss, Ss, Ss, Ss, Ss, Ss, Ss, Ss, Ss, Gg, Gg, Gg, Gg, Gg, Gg, Gg, Gg, Gg, Gg, Gg, Gg, Gg, Gg, Gg, Gg, Hh, Hh, Hh, Hh
Gg, Gg, Gg, Gg, Gg, Gg, Gg, Gg, Gg, Gg, Gg, Gg, Ss, Ss, Ss, Ss, Ss, Ss, Ss, Ss, Ss, Ss, Ss, Ss, Gg, Gg, Gg, Gg, Gg, Gg, Gg, Gg, Gg, Gg, Gg, Gg, Gg, Uu^Vu, Gg, Gg, Gg, Hh, Hh, Hh, Hh, Hh
Gg, Gg, Gg, Gg, Gg, Gg, Gg, Gg, Gg, Gg, Ss, Ss, Ss, Ss, Ss, Ss, Ss, Gg, Gg, Gg, Gg, Ss, Gg, Gg, Gg, Gg, Gg, Gg, Gg, Gg, Gg, Gg, Gg, Gg, Gg, Gg, Gg, Gg, Gg, Gg^Dr, Hh, Hh, Hh, Hh, Hh, Hh
Gg, Gg, Gg, Gg, Gg, Gg, Gg, Gg, Ss, Ss, Ss, Ss, Ss, Ss, Ss, Ss, Gg, Gg, Gg, Gg, Gg, Gg, Gg, Gg, Gg, Gg, Gg, Gg, Gg, Gg, Gg, Gg, Gg, Gg, Gg^Dr, Gg, Gg, Gg, Gg, Gg, Hh, Hh, Hh, Hh, Hh, Hh
Gg, Gg, Gg, Gg, Gg, Gg, Ss, Ss, Ss, Ss, Ss, Ss, Ss, Ss, Gg, Gg, Gg, Gg, Gg, Gg, Gg, Gg, Gg, Gg, Gg, Gg, Gg, Gg, Gg, Gg, Gg, Uu^Vu, Gg, Gg, Gg, Gg, Gg, Uu^Vu, Gg, Hh, Hh, Hh, Hh, Hh, Hh, Hh
Gg, Gg, Ss, Gg, Ss, Ss, Ss, Ss, Ss, Ss, Ss, Ss, Gg, Gg, Gg, Gg, Gg, Gg, Gg, Gg, Gg, Gg, Gg, Gg, Gg, Gg, Gg, Gg, Gg, Gg, Gg, Gg, Gg, Gg, Gg, Gg, Rb^Cov, Rb^Cov, Rb^Kov, Hh, Hh, Hh, Hh, Hh, Hh^Dr, Hh
Ss, Ss, Ss, Ss, Ss, Ss, Ss, Ss, Ss, Ss, Gg, Gg, Gg, Gg, Gg, Gg, Gg, Gg, Gg, Gg, Gg, Gg, Gg, Gg, Gg, Gg, Gg, Gg, Gg, Gg, Gg, Gg^Dr, Gg, Gg, Gg, Rb^Cov, Rb^Cov, Rb^Cov, Rb^Cov, Rb^Cov, Hh, Hh, Hh, Hh, Hh, Hh
Ss, Ss, Ss, Ss, Ss, Ss, Ss, Ss, Gg^Dr, Gg, Gg^Vo, Gg, Gg, Gg, Gg, Gg, Gg, Gg, Gg, Gg, Gg, Gg, Gg, Gg, Gg, Gg, Gg, Gg^Dr, Gg, Gg, Gg, Gg, Gg, Uu^Vu, Gg, Rb^Cov, Rb^Cov, 4 Rp^Kov, Rb^Cov, Rb^Cov, Hh, Hh, Hh, Hh, Hh, Hh
Ss, Ss, Ss, Ss, Gg, Gg, Gg, Gg, Gg, Gg, Gg, Gg, Gg, Gg, Gg, Gg, Gg, Gg, Gg, Gg, Gg, Gg, Gg, Gg, Gg, Gg, Gg, Gg, Gg, Uu^Vu, Gg, Gg, Gg, Gg, Gg, Rb^Cov, Rb^Cov, Rb^Cov, Rb^Cov, Rb^Cov, Hh, Hh, Hh, Hh, Ql, Ql
Ss, Ss, Ss, Gg, Co, Gg, Gg, Gg, Gg^Vo, Gg, Gg, Gg, Gg, Gg, Gg, Gg, Gg, Gg, Gg, Gg, Gg, Gg, Gg, Gg, Gg, Gg, Gg, Gg, Gg, Gg, Gg, Gg, Gg, Gg, Hh, Hh, Hh, Rb^Cov, Hh, Hh, Hh, Hh, Ql, Ql, Ql, Ql
Gg, Ss, Co, Co, Co, Co, Co, Gg, Gg, Gg, Gg^Dr, Gg, Gg, Gg, Gg, Gg, Gg, Gg, Gg, Gg, Gg, Gg^Dr, Gg, Gg, Gg, Gg, Hh, Gg, Hh, Hh, Hh, Hh, Hh, Hh, Hh, Hh, Hh, Hh, Hh, Hh, Ql, Ql^Bs\, Ur, Cud, Cud, Ql
Gg, Gg, Co, Co, 5 Ko, Co, Co, Gg, Gg, Gg, Gg, Gg, Gg, Gg, Gg, Gg, Gg, Gg, Gg, Gg, Gg, Gg, Gg, Gg, Hh, Hh, Hh, Hh, Hh, Hh, Hh, Hh, Hh, Hh, Hh, Hh, Hh, Hh, Ql, Ql, Cud, Ur, Ur, Ur, Uu, Cud
Gg, Gg, Co, Co, Co, Co, Co, Gg, Gg^Vo, Gg, Gg, Gg, Gg^Vo, Gg, Gg, Gg, Gg, Gg, Gg, Gg, Gg, Gg, Hh, Hh, Hh, Hh, Hh, Hh, Hh, Hh, Hh^Dr, Hh, Hh, Hh, Hh, Hh, Ql, Ql, Ql, Ql, Cud, Ur, Uu, Uu, Uu, Xu
Gg, Gg, Gg, Co, Co, Co, Gg, Gg, Gg, Gg, Gg^Dr, Gg, Gg, Gg, Gg, Gg, Gg, Gg, Gg, Gg, Hh, Hh, Hh, Hh, Hh, Hh, Hh, Hh, Hh, Hh, Hh, Hh, Hh, Hh, Ql, Ql, Ql, Ql, Ql, Ql, Cud, Uu, Uu, Uu, Uu, Uu
Gg, Gg, Gg, Gg, Gg, Gg, Gg, Gg, Gg, Gg, Gg, Gg, Gg, Gg, Gg, Gg, Gg, Gg, Hh, Hh, Hh, Hh, Hh, Hh, Hh, Hh, Hh, Hh, Hh, Hh, Hh, Hh, Ql, Ql, Ql, Ql, Ql, Ql, Ql, Ql, Cud, Xu, Xu, Uu, Uu, Uu
