Hd, Hd, Dd, Dd, Dd, Dd, Dd, Dd, Hd, Hd, Hd, Hd, Dd, Dd, Ql, Dd, Dd, Dd, Dd, Hd, Hd, Hd, Hd, Dd, Dd, Dd, Dd, Dd, Dd, Dd, Dd, Hd, Hd, Dd
Hd, Hd, Hd, Dd, Dd, Dd, Dd, Dd, Dd, Hd, Dd, Dd, Dd, Dd, Ql, Dd, Dd, Dd, Dd, Dd, Dd, Hd, Dd, Dd, Dd, Dd, Dd, Dd, Dd, Dd, Dd, Hd, Hd, Hd
Dd, Hd, Hd, Dd, Dd, Dd, Dd^Dc, Dd, Dd, Dd, Dd, Dd^Dc, Dd, Dd, Dd, Ql, Dd, Dd, Dd, Dd^Dc, Dd, Dd, Dd^Vdr, Dd, Dd, Dd, Cdr, Cdr, Cdr, Dd, Dd, Dd, Dd, Hd
Gd, Dd, Dd, Dd, Dd, Dd, Dd^Edp, Dd, Dd, Dd, Dd, Dd, Dd, Dd, Dd, Ql, Ql, Dd, Dd, Dd, Dd, Dd, Dd, Dd, Dd, Dd, Cdr, 4 Kdr, Cdr, Cdr, Dd, Dd, Dd, Dd
Gd, Dd, Gd, Gd, Gd^Efm, Dd^Edp, Gs^Ft, Dd^Edp, Dd^Edp, Dd, Dd, Dd, Dd, Dd, Dd, Dd, Ql, Dd, Dd, Dd, Dd, Dd, Dd, Dd, Dd, Dd, Dd, Cdr, Cdr, Cdr, Dd, Dd, Dd^Dc, Dd
Gd, Gd, Gd, Gd, Gd^Efm, Gs^Fds, Gg^Fet, Gs^Ft, Dd^Edp, Dd, Dd, Dd, Dd, Dd^Vdr, Dd, Dd, Dd, Ql, Dd, Dd, Dd, Dd, Dd, Dd, Dd, Dd, Dd, Dd, Dd, Dd, Dd, Dd, Dd, Dd
Gs, Gd, Gs, Gs, Gd^Efm, Gs^Fds, Gs^Fds, Gs^Ft, Gd^Efm, Dd, Dd, Dd, Dd, Dd, Dd^Dc, Cd, Cd, Ql, Ql^Bs/, Dd, Dd, Dd, Dd, Dd, Dd^Dc, Dd, Dd, Dd, Dd, Dd, Dd, Dd, Xu, Xu
Gs, Gs, Gs, Gs, Gs, Gd^Efm, Gd^Efm, Gd^Efm, Gd, Dd, Dd, Dd, Dd, Dd, Dd, Cd, 2 Kd, Cd, Ql, Ql, Dd, Dd, Dd, Dd, Dd, Dd, Dd, Dd, Dd, Dd, Xu, Xu, Xu, Xu
Gs, Gs, Gs, Gs, Gs, Gs, Gs, Gd, Gd, Gd, Gd, Dd, Dd, Dd, Dd, Cd, Cd, Cd, Dd, Ql, Ql, Dd, Dd, Dd^Vdr, Dd, Dd, Dd, Dd, Dd, Dd, Urb^Ii, Urb^Ii, Urb^Ii, Urb^Ii
Gll^Fmf, Gs, Gg, Gg^Ve, Gg, Gs, Gs, Gs, Gd, Gd, Gd, Dd, Gd, Dd, Dd, Dd, Dd, Cd, Dd, Dd, Dd, Ql, Ql^Bs/, Dd, Ql^Bs|, Dd, Dd, Dd, Dd, Dd, Xu, Urb^Ii, Urb^Ii, Urb^Ii
Gll^Fmf, Gll^Fmf, Gg, Gg, Gg, Gg, Gs, Gs, Gs, Gd, Gd, Gd, Gd, Gd, Gd, Dd, Dd, Dd, Dd^Dc, Dd, Dd, Dd, Dd, Ql, Dd, Ql, Ql^Bs|, Dd, Dd, Dd, Dd, Xu, Xu, Xu
Gll^Fmf, Gll^Fmf, Gg, Gg, Gg, Gg, Gg, Gs, Gs, Gs, Gs, Gd, Gs, Gd, Gd, Gd, Dd, Dd, Dd, Dd, Dd, Dd, Dd, Dd, Dd, Dd, Dd, Ql, Ql^Bs/, Dd, Dd, Dd, Dd, Xu
Gll^Fmf, Gll^Fmf, Gg, Gg, Ce, Ce, Ce, Gg, Gg, Gs, Gs, Gs, Gs, Gs, Gs, Gd, Gd, Dd, Dd, Dd, Dd, Dd, Dd, Dd, Dd, Dd, Cdr, Dd, Dd, Ql, Ql, Dd, Dd, Dd
Gll^Fmf, Gll^Fmf, Gg, Gg, Ce, Ke, Ce, Gg, Gg^Ve, Gg, Gg, Gs, Gs, Gs, Gs, Gd, Gd, Gd, Gd, Dd, Dd, Dd, Dd, Dd^Vdr, Dd, Cdr, 3 Kdr, Cdr, Cdr, Dd, Dd, Ql, Ql, Dd
Gll^Fmf, Gll^Fmf, 1 Gg, Gg, Gg, Ce, Gg, Gg, Gg, Gg, Gll^Fmf, Gg, Gg, Gs, Gs, Gs, Gg^Ve, Gd, Gd, Gd, Gd, Dd, Dd, Dd, Dd, Cdr, Cdr, Cdr, Cdr, Dd, Dd, Dd, Dd^Dc, Ql
Gg, Gg, Gg, Gg, Gll^Fmf, Gg, Gll^Fmf, Gg, Gll^Fmf, Gll^Fmf, Gll^Fmf, Gll^Fmf, Gll^Fmf, Gg, Gg, Gs, Gs, Gs, Gs, Gd, Gd, Dd, Dd, Dd, Dd, Dd, Dd, Cdr, Dd, Dd, Dd, Dd, Hd, Dd
Gg, Gg, Gll^Fmf, Gll^Fmf, Gll^Fmf, Gll^Fmf, Gll^Fmf, Gll^Fmf, Gll^Fmf, Gll^Fmf, Gll^Fmf, Gll^Fmf, Gll^Fmf, Gll^Fmf, Gg, Gs, Gs, Gs, Gs, Gd, Gd, Gd, Gd, Dd, Dd, Dd, Dd, Dd, Dd, Dd, Hd, Hd, Hd, Hd
