Hd, Hd, Dd, Dd, Dd, Dd, Dd, Dd, Hd, Hd, Hd, Hd, Dd, Dd, Ql, Dd, Dd, Dd, Dd, Hd, Hd, Hd, Hd, Dd, Dd, Dd, Dd, Dd, Dd, Dd, Dd, Hd, Hd, Dd
Hd, Hd, Hd, Dd, Dd, Dd, Dd, Dd, Dd, Hd, Dd, Dd, Dd, Dd, Ql, Dd, Dd, Dd, Dd, Dd, Dd, Hd, Dd, Dd, Dd, Dd, Dd, Dd, Dd, Dd, Dd, Hd, Hd, Hd
Dd, Hd, Hd, Dd, Dd, Dd, Dd^Dc, Dd, Dd, Dd, Dd, Dd^Dc, Dd, Dd, Dd, Ql, Dd, Dd, Dd, Dd^Dc, Dd, Dd, Dd, Dd, Dd, Dd, Cud, Cud, Cud, Dd, Dd, Dd, Dd, Hd
Gd, Dd, Dd, Dd, Dd, Dd, Dd, Dd, Dd, Dd, Dd, Dd, Dd, Dd, Dd, Ql, Ql, Dd, Dd, Dd, Dd, Dd, Dd, Dd, Dd, Dd, Cud, 4 Kud, Cud, Cud, Dd, Dd, Dd, Dd
Gd, Dd, Gd, Gd, Gd, Dd, Dd, Dd, Dd, Dd, Dd, Dd, Dd, Dd, Dd, Dd, Ql, Dd, Dd, Dd, Dd, Dd, Dd, Dd, Dd, Dd, Dd, Cud, Cud, Cud, Dd, Dd, Dd^Dc, Dd
Gd, Gd, Gd, Gd, Gd, Gd, Gd, Dd, Dd, Dd, Dd, Dd, Dd, Dd, Dd, Dd, Dd, Ql, Dd, Dd, Dd, Dd, Dd, Dd, Dd, Dd, Dd, Dd, Dd, Dd, Dd, Dd, Dd, Dd
Gs, Gd, Gs, Gs, Gd, Gd, Gd, Gd, Gd, Dd, Dd, Dd, Dd, Dd, Dd^Dc, Dd, Dd, Ql, Ql^Bs/, Dd, Dd, Dd, Dd, Dd, Dd^Dc, Dd, Dd, Dd, Dd, Dd, Dd, Dd, Xu, Dd
Gs, Gs, Gs, Gs, Gs, Gd, Gd, Gd, Gd, Dd, Dd, Dd, Dd, Dd, Dd, Dd, Dd, Dd, Ql, Ql, Dd, Dd, Dd, Dd, Dd, Dd, Dd, Dd, Dd, Dd, Xu, Xu, Xu, Xu
Gs, Gs, Gs, Gs, Gs, Gs, Gs, Gd, Gd, Gd, Gd, Dd, Dd, Dd, Dd, Dd, Dd, Dd, Dd, Ql, Ql, Dd, Dd, Dd, Dd, Dd, Dd, Dd, Dd, Dd, Urb^Ii, Urb^Ii, Urb^Ii, Urb^Ii
Gll^Fmf, Gs, Gg, Gg, Gg, Gs, Gs, Gs, Gd, Gd, Gd, Dd, Gd, Dd, Dd, Dd, Dd, Dd, Dd, Dd, Dd, Ql, Ql^Bs/, Dd, Ql^Bs|, Dd, Dd, Dd, Dd, Dd, Xu, Urb^Ii, Urb^Ii, Urb^Ii
Gll^Fmf, Gll^Fmf, Gg, Gg, Gg, Gg, Gs, Gs, Gs, Gd, Gd, Gd, Gd, Gd, Gd, Dd, Dd, Dd, Dd^Dc, Dd, Dd, Dd, Dd, Ql, Dd, Ql, Ql^Bs|, Dd, Dd, Dd, Dd, Xu, Xu, Xu
Gll^Fmf, Gll^Fmf, Gg, Gg, Gg, Gg, Gg, Gs, Gs, Gs, Gs, Gd, Gs, Gd, Gd, Gd, Dd, Dd, Dd, Dd, Dd, Dd, Dd, Dd, Dd, Dd, Dd, Ql, Ql^Bs/, Dd, Dd, Dd, Dd, Dd
Gll^Fmf, Gll^Fmf, Gg, Gg, Chr, Gg, Gg, Gg, Gg, Gs, Gs, Gs, Gs, Gs, Gs, Gd, Gd, Dd, Dd, Dd, Dd, Dd, Dd, Dd, Dd, Dd, Cud, Dd, Dd, Ql, Ql, Dd, Dd, Dd
Gll^Fmf, Gll^Fmf, Chr, Chr, 2 Kte, Chr, Chr, Gg, Gg, Gg, Gg, Gs, Gs, Gs, Gs, Gd, Gd, Gd, Gd, Dd, Dd, Dd, Dd, Dd, Dd, Cud, 3 Kud, Cud, Cud, Dd, Dd, Ql, Ql, Dd
Gll^Fmf, Gll^Fmf, 1 Gg, Chr, Chr, Chr, Gg, Gg, Gg, Gg, Gll^Fmf, Gg, Gg, Gs, Gs, Gs, Gs, Gd, Gd, Gd, Gd, Dd, Dd, Dd, Dd, Cud, Cud, Cud, Cud, Dd, Dd, Dd, Dd^Dc, Ql
Gg, Gg, Gg, Gg, Gll^Fmf, Gg, Gll^Fmf, Gg, Gll^Fmf, Gll^Fmf, Gll^Fmf, Gll^Fmf, Gll^Fmf, Gg, Gg, Gs, Gs, Gs, Gs, Gd, Gd, Dd, Dd, Dd, Dd, Dd, Dd, Cud, Dd, Dd, Dd, Dd, Hd, Dd
Gg, Gg, Gll^Fmf, Gll^Fmf, Gll^Fmf, Gll^Fmf, Gll^Fmf, Gll^Fmf, Gll^Fmf, Gll^Fmf, Gll^Fmf, Gll^Fmf, Gll^Fmf, Gll^Fmf, Gg, Gs, Gs, Gs, Gs, Gd, Gd, Gd, Gd, Dd, Dd, Dd, Dd, Dd, Dd, Dd, Hd, Hd, Hd, Hd
