Xuc, Xuc, Xuc, Xuc, Xuc, Xuc, Xuc, Xuc, Xuc, Xuc, Xuc, Xuc, Xuc, Xuc, Xuc, Xuc, Xuc, Xuc, Xuc, Xuc, Xuc, Xuc, Xuc, Xuc, Xuc, Xuc, Xuc, Xuc, Xuc, Xuc, Xuc, Xuc, Xuc, Xuc, Xuc, Xuc, Xuc, Xuc, Xuc, Xuc, Xuc, Xuc, Xuc, Xuc, Xuc, Xuc, Xuc, Xuc, Xuc, Xuc, Xuc, Xuc, Xuc, Xuc, Xuc, Xuc, Xuc, Xuc, Xuc, Xuc, Xuc, Xuc, Xuc, Xuc, Xuc, Xuc, Xuc, Xuc, Xuc, Xuc, Xuc, Xuc, Xuc, Xuc, Xuc, Xuc
Xuc, Xuc, Xuc, Xuc, Xuc, Xuc, Xuc, Xuc, Xuc, Xuc, Xuc, Xuc, Xuc, Xuc, Xuc, Xuc, Xuc, Xuc, Xuc, Xuc, Xuc, Xuc, Xuc, Xuc, Xuc, Xuc, Xuc, Xuc, Xuc, Xuc, Xuc, Xuc, Xuc, Xuc, Xuc, Xuc, Xuc, Xuc, Xuc, Xuc, Xuc, Xuc, Xuc, Xuc, Uu^Ii, Xuc, Xuc, Xuc, Xuc, Xuc, Xuc, Xuc, Xuc, Xuc, Xuc, Xuc, Xuc, Xuc, Xuc, Xuc, Xuc, Xuc, Xuc, Xuc, Xuc, Xuc, Xuc, Xuc, Xuc, Xuc, Xuc, Xuc, Xuc, Xuc, Xuc, Xuc
Xuc, Xuc, Xuc, Xuc, Xuc, Xuc, Xuc, Xuc, Xuc, Xuc, Xuc, Xuc, Xuc, Xuc, Xuc, Xuc, Xuc, Xuc, Xuc, Xuc, Xuc, Xuc, Xuc, Xuc, Xuc, Xuc, Xuc, Xuc, Xuc, Xuc, Xuc, Xuc, Xuc, Xuc, Xuc, Xuc, Xuc, Xuc, Xuc, Xuc, Xuc, Xuc, Xuc, Xuc, Xuc, Ur, Uu, Xuc, Xuc, Xuc, Xuc, Xuc, Xuc, Xuc, Xuc, Xuc, Xuc, Xuc, Xuc, Xuc, Xuc, Xuc, Xuc, Xuc, Xuc, Xuc, Xuc, Xuc, Xuc, Xuc, Xuc, Xuc, Xuc, Xuc, Xuc, Xuc
Xuc, Xuc, Xuc, Xuc, Xuc, Xuc, Xuc, Xuc, Xuc, Xuc, Xuc, Xuc, Xuc, Xuc, Xuc, Xuc, Xuc, Xuc, Xuc, Xuc, Xuc, Xuc, Xuc, Xuc, Xuc, Xuc, Xuc, Xuc, Xuc, Xuc, Xuc, Xuc, Xuc, Xuc, Xuc, Xuc, Xuc, Xuc, Xuc, Xuc, Xuc, Xuc, Xuc, Xuc, Xuc, Xuc, Uu, Xuc, Xuc, Xuc, Xuc, Xuc, Xuc, Xuc, Xuc, Xuc, Xuc, Xuc, Xuc, Xuc, Xuc, Xuc, Xuc, Xuc, Xuc, Xuc, Xuc, Xuc, Xuc, Xuc, Xuc, Xuc, Xuc, Xuc, Xuc, Xuc
Xuc, Xuc, Xuc, Xuc, Xuc, Xuc, Xuc, Xuc, Xuc, Xuc, Xuc, Xuc, Xuc, Xuc, Xuc, Xuc, Xuc, Xuc, Xuc, Xuc, Xuc, Xuc, Xuc, Xuc, Xuc, Xuc, Xuc, Xuc, Xuc, Xuc, Ur^Ii, Xuc, Xuc, Xuc, Xuc, Xuc, Xuc, Xuc, Xuc, Xuc, Xuc, Xuc, Uu, Xuc, Ur, Uu, Ur, Xuc, Xuc, Xuc, Xuc, Xuc, Xuc, Xuc, Xuc, Xuc, Xuc, Xuc, Xuc, Xuc, Xuc, Xuc, Xuc, Xuc, Xuc, Xuc, Xuc, Xuc, Xuc, Xuc, Xuc, Xuc, Xuc, Xuc, Xuc, Xuc
Xuc, Xuc, Xuc, Xuc, Xuc, Xuc, Xuc, Xuc, Xuc, Xuc, Xuc, Xuc, Xuc, Xuc, Xuc, Xuc, Xuc, Xuc, Xuc, Xuc, Xuc, Xuc, Xuc, Xuc, Xuc, Xuc, Xuc, Xuc, Xuc, Xuc, Xuc, Ur, Uu, Xuc, Xuc, Xuc, Xuc, Xuc, Xuc, Uu^Vud, Ur, Uu, Xu, Ur, Xu, Xu, Uu^Vud, Ur, Ur, Xuc, Xuc, Xuc, Xuc, Xuc, Xuc, Xuc, Xuc, Xuc, Xuc, Xuc, Xuc, Xuc, Xuc, Xuc, Xuc, Xuc, Xuc, Xuc, Xuc, Xuc, Xuc, Xuc, Xuc, Xuc, Xuc, Xuc
Xuc, Xuc, Xuc, Xuc, Xuc, Xuc, Xuc, Xuc, Xuc, Xuc, Xuc, Xuc, Xuc, Xuc, Xuc, Xuc, Xuc, Xuc, Xuc, Xuc, Xuc, Xuc, Xuc, Xuc, Xuc, Xuc, Xuc, Xuc, Xuc, Xuc, Xuc, Uu^Vud, Ur, Ur, Uu, Xuc, Xuc, Xuc, Xuc, Uu, Xu, Xu, Xu, Xu, Xu, Xu, Xu, Xu, Ur, Xuc, Xuc, Xuc, Xuc, Xuc, Xuc, Xuc, Xuc, Xuc, Xuc, Xuc, Xuc, Xuc, Xuc, Xuc, Xuc, Xuc, Xuc, Xuc, Xuc, Xuc, Xuc, Xuc, Xuc, Xuc, Xuc, Xuc
Xuc, Xuc, Xuc, Xuc, Xuc, Xuc, Xuc, Xuc, Xuc, Xuc, Xuc, Xuc, Xuc, Xuc, Xuc, Xuc, Xuc, Xuc, Xuc, Xuc, Xuc, Xuc, Xuc, Xuc, Xuc, Xuc, Xuc, Xuc, Xuc, Xuc, Xuc, Xuc, Xuc, Ur, Uu, Uu, Xuc, Xuc, Xuc, Uu, Qxu, Qxu, Qxu, Xu, Qxu, Xu, Qxu, Xu, Xu, Qxu, Xuc, Xuc, Xuc, Xuc, Xuc, Xuc, Xuc, Xuc, Xuc, Xuc, Xuc, Xuc, Xuc, Xuc, Xuc, Xuc, Xuc, Xuc, Xuc, Xuc, Xuc, Xuc, Xuc, Xuc, Xuc, Xuc
Xuc, Xuc, Xuc, Xuc, Xuc, Xuc, Xuc, Xuc, Xuc, Xuc, Xuc, Uu^Vud, Ur, Uu^Vud, Xuc, Xuc, Xuc, Xuc, Xuc, Xuc, Xuc, Xuc, Xuc, Xuc, Xuc, Xuc, Xuc, Xuc, Xuc, Xuc, Xuc, Xuc, Xuc, Xuc, Xuc, Uu, Uu, Xuc, Uu, Uu, Xuc, Xuc, Xuc, Qxu, Xuc, Qxu, Xuc, Qxu, Qxu, Qxu, Qxu, Xuc, Xuc, Xuc, Xuc, Xuc, Xuc, Xuc, Xuc, Xuc, Xuc, Xuc, Xuc, Xuc, Xuc, Xuc, Xuc, Xuc, Xuc, Xuc, Xuc, Xuc, Xuc, Xuc, Xuc, Xuc
Xuc, Xuc, Xuc, Xuc, Xuc, Xuc, Xuc, Xuc, Xuc, Xuc, Uu^Vud, Ur, Uu^Vud, Ur, Uu^Vud, Xuc, Uu, Xuc, Uu, Xuc, Xuc, Xuc, Xuc, Xuc, Xuc, Xuc, Xuc, Xuc, Xuc, Xuc, Xuc, Xuc, Xuc, Xuc, Xuc, Xuc, Rr, Uu, Xuc, Xuc, Xuc, Xuc, Xuc, Xuc, Xuc, Xuc, Xuc, Xuc, Xuc, Xuc, Xuc, Qxu, Ur^Ii, Xuc, Xuc, Xuc, Xuc, Xuc, Xuc, Xuc, Xuc, Xuc, Xuc, Xuc, Xuc, Xuc, Xuc, Xuc, Xuc, Xuc, Xuc, Xuc, Xuc, Xuc, Xuc, Xuc
Xuc, Xuc, Xuc, Xuc, Xuc, Xuc, Xuc, Xuc, Ur, Xuc, Ur, Ur, Uu, Ur, Ur, Ur, Ur, Uu, Uu, Uu, Uu, Xuc, Uu, Xuc, Xuc, Xuc, Xuc, Xuc, Xuc, Xuc, Xuc, Xuc, Xuc, Xuc, Xuc, Xuc, Rr, Rr, Rr, Xuc, Xuc, Xuc, Xuc, Xuc, Xuc, Xuc, Xuc, Xuc, Xuc, Xuc, Xuc, Xuc, Xuc, Xuc, Xuc, Xuc, Xuc, Xuc, Xuc, Xuc, Xuc, Xuc, Xuc, Xuc, Xuc, Xuc, Xuc, Xuc, Xuc, Xuc, Xuc, Xuc, Xuc, Xuc, Xuc, Xuc
Xuc, Xuc, Xuc, Xuc, Ur, Xuc, Ur, Ur, Ur, Ur, Uu, Uu, Uu, Uu, Uu, Ur, Ur, Ur, Ur, Ur, Ur, Uu, Ur, Ur, Ur, Xuc, Xuc, Xuc, Xuc, Xuc, Xuc, Xuc, Xuc, Ur^Ii, Ur, Xuc, Rr, Rr, Rr, Rr, Uu^Vud, Xuc, Xuc, Xuc, Xuc, Xuc, Xuc, Xuc, Xuc, Xuc, Xuc, Xuc, Xuc, Xuc, Xuc, Xuc, Xuc, Xuc, Xuc, Xuc, Xuc, Xuc, Xuc, Xuc, Xuc, Xuc, Xuc, Xuc, Xuc, Xuc, Xuc, Xuc, Xuc, Xuc, Xuc, Xuc
Xuc, Xuc, Ur, Ur, Ur, Cud, Ur, Ur, Ur, Ur, Uu, Uu, Uu, Ur, Uu, Ur, Cud, Ur, Ur, Ur, Ur, Ur, Ur, Ur, Ur, Uu, Xuc, Xuc, Xuc, Xuc, Xuc, Xuc, Xuc, Xuc, Xuc, Rr, Rr, Rr, Rr, Rr, Rr, Xuc, Xuc, Xuc, Xuc, Xuc, Xuc, Xuc, Xuc, Xuc, Xuc, Xuc, Xuc, Xuc, Xuc, Xuc, Xuc, Xuc, Xuc, Xuc, Xuc, Xuc, Xuc, Xuc, Xuc, Xuc, Xuc, Xuc, Xuc, Xuc, Xuc, Xuc, Xuc, Xuc, Xuc, Xuc
Xuc, Ur, Ur, Cud, Ur, Ur, Ur, Cud, Ur, Ur, Uu, Uu, Ur, Uu, Cud, Ur, Ur, Ur, Cud, Ur, Uu, Uu, Uu, Ur, Ur, Uu, Uu, Xuc, Xuc, Xuc, Xuc, Xuc, Xuc, Xuc, Rr, Rr, Rr, Rr, Rr, Rr, Rr, Rr, Rr, Xuc, Xuc, Xuc, Xuc, Xuc, Xuc, Xuc, Xuc, Xuc, Xuc, Xuc, Xuc, Xuc, Xuc, Xuc, Xuc, Xuc, Xuc, Xuc, Xuc, Xuc, Xuc, Xuc, Xuc, Xuc, Xuc, Xuc, Xuc, Xuc, Xuc, Xuc, Xuc, Xuc
Xuc, Ur, Ur, Ur, Ur, Kud, Ur, Ur, Ur, Ur, Ur, Ur, Ur, Ur, Ur, Ur, Kud, Ur, Ur, Ur, Uu, Uu, Uu, Ur, Uu, Uu, Uu, Xuc, Xuc, Xuc, Qxu, Xuc, Rr, Rr, Uu^Vud, Rr, Uu^Vud, Rr, Rr, Rr, Qxu, Rr, Rr, Xuc, Xuc, Xuc, Xuc, Xuc, Xuc, Xuc, Xuc, Xuc, Xuc, Xuc, Xuc, Xuc, Xuc, Xuc, Xuc, Xuc, Ur, Xuc, Ur, Xuc, Xuc, Xuc, Xuc, Xuc, Xuc, Xuc, Xuc, Xuc, Xuc, Xuc, Xuc, Xuc
Xuc, Ur, Ur, Cud, Ur, Ur, Ur, Cud, Uu, Ur, Uu, Ur, Ur, Ur, Cud, Ur, Ur, Ur, Cud, Ur, Ur, Uu, Uu, Ur, Uu, Uu, Xuc, Xuc, Qxu, Qxu, Rr, Rr, Rr, Rr, Urb, Urb, Urb, Rr, Rr, Rr, Qxu, Qxu, Rr, Rr, Xuc, Xuc, Xuc, Xuc, Xuc, Xuc, Xuc, Xuc, Xuc, Xuc, Xuc, Xuc, Xuc, Xuc, Ur, Ur, Ur, Ur, Rr, Ur, Ur, Xuc, Xuc, Xuc, Xuc, Xuc, Xuc, Xuc, Xuc, Xuc, Xuc, Xuc
Xuc, Ur, Uu, Uu, Ur, Cud, Ur, Ur, Uu, Uu, Uu, Ur, Ur, Ur, Ur, Ur, Cud, Ur, Ur, Ur, Ur, Ur, Ur, Ur, Xuc, Xuc, Qxu, Qxu, Rr, Rr, Rr, Rr, Urb, Urb, Urb, Uu^Srot, Urb, Urb, Urb, Rr, Rr, Rr, Rr, Rr, Xuc, Xuc, Xuc, Xuc, Xuc, Xuc, Xuc, Xuc, Xuc, Xuc, Xuc, Xuc, Ur, Ur, Rr, Rr, Rr, Rr, Rr, Rr, Rr, Ur, Ur, Xuc, Xuc, Xuc, Xuc, Xuc, Xuc, Xuc, Xuc, Xuc
Xuc, Xuc, Uu, Uu, Uu, Ur, Ur, Uu, Ur, Uu, Uu, Uu, Ur, Ur, Ur, Ur, Ur, Ur, Ur, Ur, Ur, Ur, Ur, Xuc, Xuc, Qxu, Qxu, Rr, Rr, Rr, Urb, Urb, Urb, Urb, Uu, Uu, Uu, Urb, Urb, Urb, Urb, Rr, Rr, Rr, Xuc, Xuc, Xuc, Xuc, Xuc, Xuc, Xuc, Xuc, Xuc, Xuc, Xuc, Ur, Rr, Rr, Rr, Rr, Kud, Rr, Rr, Rr, Rr, Rr, Ur, Ur, Xuc, Xuc, Xuc, Xuc, Xuc, Xuc, Xuc, Xuc
Xuc, Xuc, Xuc, Uu, Uu, Uu, Xuc, Ur, Xuc, Ur, Xuc, Ur, Qxu, Ur, Uu, Ur, Ur, Ur, Ur, Ur, Ur, Ur, Ur, Xuc, Xuc, Qxu, Rr, Uu^Vud, Urb, Urb, Urb, Urb, Urb, Uu^Sra, Uu, Uu^Sct, Uu, Uu^Srj, Urb, Urb, Urb, Urb, Urb, Uu^Vud, Qxu, Qxu, Xuc, Xuc, Xuc, Xuc, Xuc, Xuc, Xuc, Xuc, Ur, Ur, Rr, Rr, Rr, Rr, Rr, Rr, Rr, Rr, Rr, Rr, Rr, Ur, Ur, Xuc, Xuc, Xuc, Xuc, Xuc, Xuc, Xuc
Xuc, Xuc, Xuc, Xuc, Xuc, Xuc, Xuc, Xuc, Xuc, Xuc, Xuc, Qxu, Qxu, Qxu, Qxu, Qxu, Qxu, Uu, Uu, Uu, Uu, Uu, Ur, Ur, Xuc, Qxu, Rr, Urb, Urb, Urb, Urb, Urb, Uu, Uu, Uu, Uu, Uu, Uu, Uu, Urb, Urb, Urb, Urb, Urb, Qxu, Qxu, Xuc, Xuc, Xuc, Xuc, Xuc, Xuc, Xuc, Xuc, Ur, Ur, Rr, Rr, Rr, Rr, Rr, Rr, Rr, Rr, Rr, Rr, Rr, Rr, Ur, Xuc, Xuc, Xuc, Xuc, Xuc, Xuc, Xuc
Xuc, Xuc, Xuc, Xuc, Xuc, Xuc, Xuc, Xuc, Xuc, Xuc, Xuc, Xuc, Xuc, Qxu, Qxu, Qxu, Qxu, Qxu, Qxu, Ur, Ur, Ur, Ur, Ur, Ur, Xuc, Rr, Urb, Urb, Urb, Urb, Uu^Srjl, Urb, Uu, Urb, Uu^Srgt, Urb, Uu, Urb, Uu^Srs, Urb, Urb, Urb, Urb, Qxu, Qxu, Xuc, Xuc, Xuc, Xuc, Xuc, Xuc, Xuc, Xuc, Ur, Rr, Rr, Rr, Rr, Rr, Rr, Rr, Rr, Rr, Rr, Rr, Rr, Rr, Ur, Xuc, Xuc, Xuc, Xuc, Xuc, Xuc, Xuc
Xuc, Xuc, Xuc, Xuc, Xuc, Xuc, Xuc, Xuc, Xuc, Xuc, Xuc, Xuc, Xuc, Xuc, Xuc, Qxu, Qxu, Qxu, Qxu, Ur, Ur, Ur, Ur, Ur, Xuc, Xuc, Rr, Urb, Uu^Vud, Urb, Rr, Urb, Rr, Urb, Rr, Urb, Rr, Urb, Rr, Urb, Rr, Urb, Uu^Vud, Urb, Qxu, Qxu, Xuc, Xuc, Xuc, Xuc, Xuc, Xuc, Xuc, Xuc, Ur, Rr, Rr, Rr, Rr, Rr, Rr, Rr, Rr, Rr, Rr, Rr, Ur, Ur, Xuc, Xuc, Xuc, Xuc, Xuc, Xuc, Xuc, Xuc
Xuc, Xuc, Xuc, Xuc, Xuc, Xuc, Xuc, Xuc, Xuc, Xuc, Xuc, Xuc, Xuc, Xuc, Xuc, Xuc, Xuc, Qxu, Qxu, Qxu, Qxu, Ur, Ur, Xuc, Qxu, Qxu, Qxu, Rr, Rr, Rr, Rr, Rr, Rr, Rr, Rr, Rr, Rr, Rr, Rr, Rr, Rr, Rr, Rr, Rr, Rr, Qxu, Xuc, Xuc, Xuc, Xuc, Xuc, Xuc, Xuc, Xuc, Xuc, Ur, Rr, Rr, Rr, Rr, Rr, Rr, Rr, Rr, Ur, Ur, Xuc, Xuc, Xuc, Xuc, Xuc, Xuc, Xuc, Xuc, Xuc, Xuc
Xuc, Xuc, Xuc, Xuc, Xuc, Xuc, Xuc, Xuc, Xuc, Xuc, Xuc, Xuc, Xuc, Xuc, Xuc, Xuc, Xuc, Xuc, Xuc, Qxu, Qxu, Ur, Ur, Xuc, Qxu, Qxu, Qxu, Rr, Rr, Rr, Rr, Rr, Rr, Rr, Rr, Rr, Rr, Rr, Rr, Rr, Rr, Rr, Rr, Rr, Rr, Xuc, Xuc, Xuc, Xuc, Xuc, Xuc, Xuc, Xuc, Xuc, Xuc, Ur, Ur, Rr, Rr, Rr, Rr, Rr, Rr, Rr, Ur, Xuc, Xuc, Xuc, Xuc, Xuc, Xuc, Xuc, Xuc, Xuc, Xuc, Xuc
Xuc, Xuc, Xuc, Xuc, Xuc, Xuc, Xuc, Xuc, Xuc, Xuc, Xuc, Xuc, Xuc, Xuc, Xuc, Xuc, Xuc, Xuc, Xuc, Xuc, Qxu, Ur, Ur, Xuc, Xuc, Qxu, Qxu, Qxu, Rr, Rr, Rr, Rr, Rr, Rr, Rr, Rr, Rr, Rr, Rr, Rr, Qxu, Rr, Rr, Rr, Xuc, Xuc, Xuc, Xuc, Xuc, Xuc, Xuc, Xuc, Xuc, Xuc, Xuc, Xuc, Ur, Rr, Ur, Rr, Rr, Rr, Ur, Ur, Xuc, Xuc, Xuc, Xuc, Xuc, Xuc, Xuc, Xuc, Xuc, Xuc, Xuc, Xuc
Xuc, Xuc, Xuc, Xuc, Xuc, Xuc, Xuc, Xuc, Xuc, Xuc, Xuc, Xuc, Xuc, Xuc, Xuc, Xuc, Xuc, Xuc, Xuc, Xuc, Xuc, Xuc, Ur, Ur, Xuc, Qxu, Qxu, Qxu, Qxu, Rr, Rr, Rr, Rr, Rr, Rr, Rr, Rr, Rr, Xuc, Qxu, Xuc, Xuc, Xuc, Xuc, Uu, Xuc, Ur, Xuc, Uu, Xuc, Uu, Xuc, Uu, Xuc, Xuc, Xuc, Xuc, Ur, Xuc, Ur, Ur, Ur, Xuc, Xuc, Xuc, Xuc, Xuc, Xuc, Xuc, Xuc, Xuc, Xuc, Xuc, Xuc, Xuc, Xuc
Xuc, Xuc, Xuc, Xuc, Xuc, Xuc, Xuc, Xuc, Xuc, Xuc, Uu, Uu, Ur, Uu, Uu, Uu, Uu, Uu, Ur, Ur, Ur, Ur, Ur, Ur, Xuc, Qxu, Qxu, Qxu, Rr, Rr, Rr, Rr, Rr, Rr, Rr, Rr, Rr, Xuc, Xuc, Xuc, Uu, Xuc, Uu, Uu, Uu, Uu, Uu, Ur, Uu, Ur, Uu, Uu, Uu, Ur, Ur, Uu, Ur, Xuc, Ur, Ur, Xuc, Xuc, Xuc, Xuc, Xuc, Xuc, Xuc, Xuc, Xuc, Xuc, Xuc, Xuc, Xuc, Xuc, Xuc, Xuc
Xuc, Xuc, Xuc, Xuc, Xuc, Xuc, Xuc, Xuc, Uu, Uu, Ur, Ur, Uu, Ur, Uu, Uu, Xu, Xu, Xu, Ur, Ur, Ur, Uu, Ur, Ur, Xuc, Xuc, Qxu, Rr, Rr, Rr, Rr, Rr, Rr, Rr, Rr, Xuc, Xuc, Uu, Uu, Ur, Uu, Ur, Ur, Ur, Ur, Uu, Uu, Xuc, Uu, Xuc, Uu, Xuc, Uu, Xuc, Ur, Ur, Ur, Ur, Ur, Uu, Xuc, Xuc, Xuc, Xuc, Xuc, Xuc, Xuc, Xuc, Xuc, Xuc, Xuc, Xuc, Xuc, Xuc, Xuc
Xuc, Xuc, Xuc, Xuc, Xuc, Xuc, Xuc, Xuc, Ql, Uu, Uu, Uu, Ql, Xu, Xu, Xu, Ur, Xu, Xu, Xu, Xu, Ur, Ur, Uu, Uu, Ur, Uu, Xuc, Xuc, Rr, Rr, Rr, Rr, Rr, Xuc, Xuc, Uu, Uu, Uu, Ur, Ur, Uu, Uu, Ur, Uu, Uu, Xuc, Xuc, Xuc, Xuc, Xuc, Xuc, Xuc, Xuc, Xuc, Xuc, Xuc, Ur, Ur, Uu, Uu, Uu, Uu, Xuc, Xuc, Xuc, Xuc, Xuc, Xuc, Xuc, Xuc, Xuc, Xuc, Xuc, Xuc, Xuc
Xuc, Xuc, Xuc, Xuc, Xuc, Xuc, Xuc, Xuc, Ql, Uu, Ql^Bs|, Uu, Ql^Bs\, Xu, Ur, Ur, Xuc, Ur, Ur, Xu, Xu, Xu, Xu, Uu, Ur, Ur, Ur, Uu, Xuc, Rr, Rr, Rr, Rr, Rr, Xuc, Uu, Ur, Ur, Uu, Ur, Uu, Uu, Ur, Uu, Xuc, Xuc, Xuc, Xuc, Xuc, Xuc, Xuc, Xuc, Xuc, Xuc, Xuc, Xuc, Xuc, Xuc, Xuc, Uu, Uu, Ur, Ur, Uu, Uu, Xuc, Xuc, Xuc, Xuc, Xuc, Xuc, Xuc, Xuc, Xuc, Xuc, Xuc
Xuc, Xuc, Xuc, Xuc, Xuc, Xuc, Xuc, Xuc, Ql, Ql, Ur, Ql, Xuc, Ur, Xuc, Xuc, Xuc, Xuc, Xuc, Ur, Ur, Xu, Xu, Xu, Xu, Ur, Ur, Uu^Vu, Xuc, Rr, Rr, Rr, Rr, Rr, Xuc, Uu, Ur, Ur, Uu, Uu, Uu, Ur, Xuc, Xuc, Xuc, Xuc, Xuc, Xuc, Xuc, Xuc, Xuc, Xuc, Xuc, Xuc, Xuc, Xuc, Xuc, Xuc, Xuc, Ur, Uu, Ur, Ur, Uu, Uu, Xuc, Xuc, Xuc, Xuc, Xuc, Xuc, Xuc, Xuc, Xuc, Xuc, Xuc
Xuc, Xuc, Xuc, Xuc, Xuc, Xuc, Xuc, Xuc, Ql, Ql, Ql^Bs|, Ql, Xuc, Ur, Ur, Xuc, Xuc, Xuc, Xuc, Xuc, Uu, Ur, Uu, Xu, Ur, Ur, Xuc, Xuc, Xuc, Rr, Rr, Rr, Rr, Xuc, Uu, Uu, Uu, Uu, Uu, Ur, Xuc, Xuc, Xuc, Xuc, Xuc, Xuc, Xuc, Xuc, Xuc, Xuc, Xuc, Xuc, Xuc, Xuc, Xuc, Xuc, Xuc, Xuc, Uu^Vu, Uu, Uu, Ur, Uu, Uu, Xuc, Xuc, Xuc, Xuc, Xuc, Xuc, Xuc, Xuc, Xuc, Xuc, Xuc, Xuc
Xuc, Xuc, Xuc, Xuc, Xuc, Xuc, Xuc, Xuc, Ql, Ql, Ur, Ql, Ql, Xuc, Xuc, Ur, Ur, Xuc, Uu, Uu, Uu, Uu, Ur, Ur, Xuc, Xuc, Xuc, Xuc, Xuc, Xuc, Xuc, Rr, Rr, Xuc, Uu, Ur, Uu, Uu, Uu, Uu, Xuc, Xuc, Xuc, Xuc, Xuc, Xuc, Xuc, Xuc, Xuc, Xuc, Xuc, Xuc, Xuc, Xuc, Xuc, Xuc, Xuc, Xuc, Uu, Uu, Uu, Uu, Uu, Xuc, Xuc, Xuc, Xuc, Xuc, Xuc, Xuc, Xuc, Xuc, Xuc, Xuc, Xuc, Xuc
Xuc, Xuc, Xuc, Xuc, Xuc, Xuc, Xuc, Ql, Ur, Ql^Bs/, Ql^Bs|, Ql^Bs\, Ur, Ql, Ql, Xuc, Xuc, Uu^Vu, Ur, Uu, Ur, Uu^Vu, Xuc, Xuc, Xuc, Xuc, Xuc, Xuc, Xuc, Xuc, Urb, Ur, Ur, Xuc, Uu, Ur, Uu, Ur, Ur, Ur, Xuc, Xuc, Xuc, Xuc, Xuc, Xuc, Xuc, Xuc, Xuc, Xuc, Xuc, Xuc, Xuc, Xuc, Xuc, Xuc, Xuc, Xuc, Uu, Uu, Uu, Uu, Uu^Vu, Xuc, Xuc, Xuc, Xuc, Xuc, Xuc, Xuc, Xuc, Xuc, Xuc, Xuc, Xuc, Xuc
Xuc, Xuc, Xuc, Xuc, Xuc, Xuc, Xuc, Ql, Ql^Bs|, Ql, Ur, Ql^Bs/, Ql, Ql^Bs\, Ur, Ql, Ql, Xuc, Xuc, Uu^Vu, Xuc, Xuc, Xuc, Xuc, Urb, Xuc, Urb, Xuc, Xuc, Xuc, Urb, Urb, Urb, Xuc, Xuc, Uu, Uu, Uu, Uu, Ur, Uu, Xuc, Xuc, Xuc, Xuc, Xuc, Xuc, Xuc, Xuc, Xuc, Xuc, Xuc, Xuc, Xuc, Xuc, Xuc, Xuc, Xuc, Uu, Uu, Uu, Uu, Xuc, Xuc, Ur, Xuc, Xuc, Xuc, Xuc, Xuc, Xuc, Xuc, Xuc, Xuc, Xuc, Xuc
Xuc, Xuc, Xuc, Xuc, Xuc, Xuc, Xuc, Ql, Ur, Ql^Bs/, Ql, Ql, Xuc, Ql, Ql, Ql^Bs\, Ur, Ql, Ql, Xuc, Xuc, Xuc, Urb, Urb, Urb, Urb, Urb, Urb, Urb, Urb, Ur, Urb, Urb, Urb, Urb, Xuc, Xuc, Uu, Ur, Ur, Ur, Ur, Xu^Dr, Xuc, Xuc, Xuc, Xuc, Xuc, Xuc, Xuc, Xuc, Xuc, Xuc, Xuc, Xuc, Xuc, Xuc, Xuc, Xuc, Uu, Uu^Vu, Uu, Xuc, Ur, Ur, Uu^Vud, Ur, Xuc, Xuc, Xuc, Xuc, Xuc, Xuc, Xuc, Xuc, Xuc
Xuc, Xuc, Xuc, Xuc, Xuc, Xuc, Xuc, Ql, Ql, Ql, Xuc, Xuc, Xuc, Xuc, Xuc, Ql, Ql, Ql^Bs\, Urb, Xuc, Cud^Xo, Xuc, Cud^Xo, Urb, Urb, Urb, Urb, Urb, Urb, Urb, Urb, Urb, Xu, Xu, Xu, Urb, Urb, Xuc, Xuc, Uu, Ur, Uu, Xu^Dr, Xu^Dr, Urb, Xuc, Xuc, Xuc, Xuc, Xuc, Xuc, Xuc, Xuc, Xuc, Xuc, Xuc, Xuc, Xuc, Xuc, Xuc, Xuc, Xuc, Xuc, Ur, Ur, Ur, Xuc, Xuc, Ur^Cov, 3 Kud, Ur^Cov, Xuc, Xuc, Xuc, Xuc, Xuc
Xuc, Xuc, Xuc, Xuc, Xuc, Xuc, Xuc, Xuc, Xuc, Xuc, Xuc, Xuc, Xuc, Xuc, Xuc, Xuc, Xuc, Urb, Ur^Z/, Ur^Z/, Urb, Urb, Urb, Ur^Z\, Ur^Z\, Urb, Urb, Urb, Urb, Urb, Xu, Xu, Ur, Uu, Ur, Urb, Ur, Urb, Urb, Xuc, Xu^Dr, Ur, Xu^Dr, Xu^Dr, Urb, Xuc, Urb, Urb, Urb, Xuc, Xuc, Xuc, Xuc, Xuc, Xuc, Xuc, Urb, Urb, Urb, Xuc, Xuc, Xuc, Urb, Rr^Z\, Xuc, Xuc, Ur, Ur, Ur, Ur^Cov, Ur, Ur, Ur, Xuc, Xuc, Xuc
Xuc, Xuc, Xuc, Xuc, Xuc, Xuc, Xuc, Xuc, Xuc, Xuc, Xuc, Xuc, Xuc, Xuc, Xuc, Xuc, Xuc, Cud^Xo, Urb, Urb, Urb, Rr^Vd, Urb, Urb, Urb, Cud^Xo, Xu, Xu, Xu, Xu, Urb, Xu, Xu, Xu, Xu, Urb, Uu^Vud, Urb, Urb, Uu^Vud, Xu, Xu^Dr, Urb, Urb, Urb, Urb, Urb, Urb, Urb, Urb, Xuc, Xuc, Xuc, Xuc, Urb, Urb, Urb, Urb, Urb, Xuc, Urb, Urb, Urb, Urb, Xuc, Ur, Ur, Ur, Ur, Ur, Ur, Ur, Ur, Ur, Xuc, Xuc
Xuc, Xuc, Xuc, Xuc, Xuc, Xuc, Xuc, Xuc, Xuc, Xuc, Xuc, Xuc, Xuc, Xuc, Xuc, Xuc, Xuc, Urb, Urb, Urb, Urb, Urb, Urb, Urb, Urb, Urb, Cud, Urb, Urb, Urb, Urb, Urb, Urb, Urb, Urb, Xu, Xu, Xu, Xu, Xu, Urb, Urb, Urb, Urb, Urb, Urb, Urb, Urb, Urb, Urb, Urb, Urb, Urb, Urb, Urb, Urb, Urb, Urb, Urb, Urb, Urb, Urb, Urb, Urb, Xuc, Ur, Ur, Cud, Ur, Ur, Ur, Cud, Ur, Ur, Xuc, Xuc
Xuc, Xuc, Xuc, Xuc, Xuc, Xuc, Xuc, Xuc, Xuc, Xuc, Xuc, Xuc, Xuc, Xuc, Xuc, Xuc, Xuc, Urb, Urb, Urb, Rr^Vd, Ur^Srgt, Rr^Vd, Urb, Urb, Urb, Urb, Urb, Urb, Urb, Urb, Urb, Urb, Urb, Urb, Urb, Urb, Urb, Urb, Urb, Urb, Urb, Urb, Urb, Urb, Urb, Urb, Urb, Urb, Urb, Urb, Urb, Urb, Urb, Urb, Urb, Urb, Urb, Xuc, Urb, Urb, Urb, Urb, Urb, Xuc, Ur, Ur, Ur, Uh, Tb^Tfi, Uh, Ur, Ur, Ur, Xuc, Xuc
Xuc, Xuc, Xuc, Xuc, Xuc, Xuc, Xuc, Xuc, Xuc, Xuc, Xuc, Xuc, Xuc, Xuc, Xuc, Xuc, Xuc, Urb, Urb, Urb, Ur^Srot, Ur^Sct, Ur^Srjt, Urb, Urb, Urb, Urb, Urb, Urb, Urb, Urb, Urb, Urb, Urb, Urb, Urb, Urb, Urb, Urb, Urb, Urb, Urb, Urb, Urb, Urb, Urb, Urb, Urb, Urb, Urb, Urb, Urb, Urb, Urb, Urb, Urb, Xuc, Xuc, Uu, Xuc, Xuc, Xuc, Xuc, Xuc, Xuc, Ur, Uu, Ur, Ur, Ur, Ur, Ur, Uu, Ur, Xuc, Xuc
Xuc, Xuc, Xuc, Xuc, Xuc, Xuc, Xuc, Xuc, Xuc, Xuc, Xuc, Xuc, Xuc, Xuc, Xuc, Cud, Urb, Urb, Rr^Vd, Urb, Urb, Rr^Vd, Urb, Urb, Rr^Vd, Urb, Cud, Urb, Xuc, Urb, Xuc, Urb, Xuc, Xuc, Xuc, Xuc, Xuc, Xuc, Xuc, Urb, Urb, Urb, Urb, Urb, Xuc, Xuc, Xuc, Urb, Xuc, Urb, Urb, Urb, Urb, Urb, Xuc, Xuc, Uu, Uu, Ur, Uu, Ur, Uu^Vud, Uu, Xuc, Xuc, Ur, Uu, Ur, Uu, Ur, Uu, Ur, Uu, Ur, Xuc, Xuc
Xuc, Xuc, Xuc, Xuc, Xuc, Xuc, Xuc, Xuc, Xuc, Xuc, Xuc, Xuc, Xos, Xuc, Xuc, Urb, Urb, Urb, Urb, Urb, Urb, Urb, Urb, Urb, Urb, Urb, Xuc, Xuc, Xuc, Xuc, Xuc, Xuc, Xuc, Xuc, Xuc, Uu, Uu, Uu, Uu, Xuc, Xuc, Xuc, Xuc, Xuc, Xuc, Urb, Urb, Xuc, Xuc, Xuc, Urb, Urb, Urb, Urb, Xuc, Uu, Ur, Ur, Uu, Ur, Uu, Uu, Uu, Uu, Xuc, Ur, Uu, Uu, Ur, Uu, Ur, Uu, Uu, Ur, Xuc, Xuc
Xuc, Xuc, Xuc, Xuc, Xuc, Xuc, Xuc, Xuc, Xuc, Xuc, Xos, Xos, Urb, Xos, Urb, Urb, Xuc, Cud, Xuc, Urb, Urb, Urb, Urb, Urb, Ur^Z/, Cud^Xo, Urb, Xuc, Xuc, Xuc, Xuc, Xuc, Xuc, Xuc, Xuc, Uu, Uu, Uu, Uu, Uu, Uu, Uu, Uu, Uu, Xuc, Urb, Urb, Urb, Urb, Urb, Urb, Urb, Xuc, Xuc, Uu, Uu, Uu, Uu, Xuc, Xuc, Xuc, Xuc, Uu, Uu, Xuc, Ur, Ur, Ur, Ur, Ur, Ur, Ur, Ur, Ur, Xuc, Xuc
Xuc, Xuc, Xuc, Xuc, Xuc, Xuc, Xuc, Xuc, Xos, Xos, Urb, Urb, Urb, Urb, Urb, Urb, Xos, Xuc, Xuc, Xuc, Xuc, Urb, Cud^Xo, Ur^Z/, Urb, Urb, Urb, Urb, Urb, Xuc, Xuc, Xuc, Xuc, Xuc, Ur, Uu, Uu, Ur, Ur, Ur, Uu, Uu, Uu, Uu, Xuc, Xuc, Cud, Urb, Urb, Urb, Cud, Cud, Xuc, Uu, Uu, Uu, Xuc, Xuc, Xuc, Xuc, Xuc, Xuc, Xuc, Uu, Uu, Xuc, Xuc, Ur, Ur, Ur, Ur, Ur, Xuc, Xuc, Xuc, Xuc
Xuc, Xuc, Xuc, Xuc, Xuc, Xuc, Xos, Xos, Urb, Urb, Urb, Urb, Urb, Urb, Urb, Urb, Xos, Xuc, Xuc, Xuc, Xuc, Xuc, Xuc, Urb, Urb, Urb, Urb, Urb, Urb, Urb, Urb, Xuc, Xuc, Xuc, Ur, Uu, Uu, Uu, Uu, Uu, Xuc, Uu, Uu, Uu, Ur, Xuc, Xuc, Cud, Cud, Cud, Cud, Xuc, Xuc, Uu, Uu, Xuc, Xuc, Xuc, Xuc, Xuc, Xuc, Xuc, Xuc, Xuc, Uu, Uu, Xuc, Ur, Ur, Ur, Ur, Xuc, Xuc, Xuc, Xuc, Xuc
Xuc, Xuc, Xuc, Xuc, Xos, Xos, Urb, Urb, Urb, Urb, Urb, Urb, Urb, Urb, Xos, Xos, Xuc, Xuc, Xuc, Xuc, Xuc, Xuc, Xuc, Xuc, Xuc, Urb, Urb, Urb, Urb, Urb, Urb, Ur, Xuc, Xuc, Ur, Ur, Ur, Uu, Xuc, Xuc, Xuc, Xuc, Xuc, Uu, Ur, Uu, Uu, Xuc, Cud, Cud, Cud, Xuc, Xuc, Uu, Uu, Uu, Uu, Xuc, Xuc, Xuc, Xuc, Xuc, Xuc, Xuc, Ur, Ur, Xuc, Uu, Ur, Ur, Uu, Xuc, Xuc, Xuc, Xuc, Xuc
Xuc, Xuc, Xuc, Xuc, Xos, Uu^Ii, Uu^Ii, Urb, Urb, Urb, Urb, Urb, Urb, Xos, Xuc, Xuc, Xuc, Xuc, Xuc, Xuc, Xuc, Xuc, Xuc, Xuc, Xuc, Xuc, Xuc, Urb, Urb, Urb, Ur, Ur, Ur, Ur, Ur, Ur, Xuc, Xuc, Xuc, Xuc, Xuc, Xuc, Xuc, Xuc, Uu, Ur, Ur, Xuc, Xuc, Xuc, Xuc, 2 Kud, Xuc, Xuc, Uu, Ur, Uu, Uu, Uu, Xuc, Xuc, Xuc, Xuc, Xuc, Ur, Ur, Xuc, Uu, Uu, Ur, Xuc, Xuc, Xuc, Xuc, Xuc, Xuc
Xuc, Xuc, Xos, Xos, Uu^Ii, Uu^Ii, Uu^Ii, Urb, Uu^Ii, Urb, Urb, Urb, Xos, Xos, Xuc, Xuc, Xuc, Xuc, Xuc, Xuc, Xuc, Xuc, Xuc, Xuc, Xuc, Xuc, Xuc, Xuc, Xuc, Ur, Xuc, Xuc, Xuc, Xuc, Uu^Vud, Xuc, Xuc, Xuc, Xuc, Xuc, Xuc, Xuc, Xuc, Xuc, Xuc, Uu, Uu, Uu, Ur, Uu, Uu, Xuc, Uu, Uu, Ur, Ur, Uu, Uu, Uu, Xuc, Xuc, Xuc, Xuc, Xuc, Uu, Ur, Xuc, Xuc, Kud^Xo, Uu, Xuc, Xuc, Xuc, Xuc, Xuc, Xuc
Xuc, Xos, Uu^Ii, Uu^Ii, Uu^Ii, Uu^Ii, 1 Uu^Ii, Uu^Ii, Uu^Ii, Uu^Ii, Urb, Urb, Xos, Xuc, Xuc, Xuc, Xuc, Xuc, Xuc, Xuc, Xuc, Xuc, Xuc, Xuc, Xuc, Xuc, Xuc, Xuc, Xuc, Xuc, Xuc, Xuc, Xuc, Xuc, Xuc, Xuc, Xuc, Xuc, Xuc, Xuc, Xuc, Xuc, Xuc, Xuc, Uu, Uu, Uu, Uu, Ur, Ur, Uu, Uu, Ur, Ur, Uu, Ur, Uu, Uu, Xuc, Xuc, Xuc, Xuc, Xuc, Xuc, Uu, Uu, Uu, Ur, Uu, Kud^Xo, Xuc, Xuc, Xuc, Xuc, Xuc, Xuc
Xos, Xos, Uu^Ii, Uu^Ii, Uu^Ii, Uu^Ii, Uu^Ii, Uu^Ii, Uu^Ii, Uu^Ii, Urb, Xos, Xuc, Xuc, Xuc, Xuc, Xuc, Xuc, Xuc, Xuc, Xuc, Xuc, Xuc, Xuc, Xuc, Xuc, Xuc, Xuc, Xuc, Xuc, Xuc, Xuc, Xuc, Xuc, Xuc, Xuc, Xuc, Xuc, Xuc, Xuc, Xuc, Xuc, Xuc, Uu, Uu, Uu, Uu, Ur, Uu, Uu, Uu, Uu, Uu, Uu, Xuc, Uu, Xuc, Xuc, Xuc, Xuc, Xuc, Xuc, Xuc, Uu^Vud, Uu, Ur, Ur, Ur, Uu, Uu, Uu, Xuc, Xuc, Xuc, Xuc, Xuc
Uu^Ii, Uu^Ii, Uu^Ii, Uu^Ii, Uu^Ii, Uu^Ii, Uu^Ii, Uu^Ii, Uu^Ii, Uu^Ii, Xos, Xos, Xuc, Xuc, Xuc, Xuc, Xuc, Xuc, Xuc, Xuc, Xuc, Xuc, Xuc, Xuc, Xuc, Xuc, Xuc, Xuc, Xuc, Xuc, Xuc, Xuc, Xuc, Xuc, Xuc, Xuc, Xuc, Xuc, Xuc, Xuc, Xuc, Xuc, Xuc, Xuc, Xuc, Uu, Xuc, Xuc, Xuc, Uu, Xuc, Xuc, Xuc, Xuc, Xuc, Xuc, Xuc, Xuc, Xuc, Xuc, Xuc, Xuc, Xuc, Xuc, Xuc, Xuc, Xuc, Xuc, Xuc, Uu, Xuc, Xuc, Xuc, Xuc, Xuc, Xuc
Uu^Ii, Uu^Ii, Uu^Ii, Uu^Ii, Uu^Ii, Uu^Ii, Uu^Ii, Uu^Ii, Xos, Xos, Xuc, Xuc, Xuc, Xuc, Xuc, Xuc, Xuc, Xuc, Xuc, Xuc, Xuc, Xuc, Xuc, Xuc, Xuc, Xuc, Xuc, Xuc, Xuc, Xuc, Xuc, Xuc, Xuc, Xuc, Xuc, Xuc, Xuc, Xuc, Xuc, Xuc, Xuc, Xuc, Xuc, Xuc, Xuc, Xuc, Xuc, Xuc, Xuc, Xuc, Xuc, Xuc, Xuc, Xuc, Xuc, Xuc, Xuc, Xuc, Xuc, Xuc, Xuc, Xuc, Xuc, Xuc, Xuc, Xuc, Xuc, Xuc, Xuc, Xuc, Xuc, Xuc, Xuc, Xuc, Xuc, Xuc
