Aa, Aa, Aa, Aa, Aa, Aa, Aa, Aa, Aa, Aa, Ha, Ha, Ha, Ha, Ha, Ha, Ha, Ha, Ha^Fda, Ha, Ha^Fda, Ha, Ha, Ha, Ha, Ha, Ha, Ha, Ha, Ha, Ha, Ha, Ha, Ha, Ai, Ai, Ai, Ai, Wwr, Wwr, Wwr, Wwr
Aa, Aa, Aa, Aa, Aa, Aa, Re^Vct, Aa, Aa, Aa, Cea, Ha, Ha, Ha, Ha, Ha, Ha, Ha, Ha^Fda, Ha^Fda, Ha, Ha^Fda, Ha^Fda, Ha, Ha^Fda, Ha, Ha, Ha^Fda, Ha, Ha, Ha, Ha, Ha, Ai, Ai, Ai, Wwr, Wwr, Wwr, Wwr, Ai, Ai
Aa, Aa, Aa, Aa, Re^Vct, Aa, Aa, Aa, Aa, Cea, 2 Kea, Cea, Ha^Fda, Ha^Fda, Ha^Fda, Ha^Fda, Ha^Fda, Ha^Fda, Ha^Fda, Ha^Fda, Ha^Fda, Ha^Fda, Ha^Fda, Ha^Fda, Ha^Fda, Ha^Fda, Ha^Fda, Ha^Fda, Ha, Ha, Ha, Ha, Ai, Ai, Wwr, Wwr, Wwr, Wwr, Ai, Ai, Ha, Ha
Aa, Aa, Aa, Aa, Aa, Aa, Aa, Aa, Aa, Cea, Cea, Cea, Aa, Ha, Aa, Ha^Fda, Ha^Fda, Ha, Ha^Fda, Ha^Fda, Ha^Fda, Ha^Fda, Ha^Fda, Ha^Fda, Ha^Fda, Ha^Fda, Ha^Fda, Ha^Fda, Ha, Ha, Ha, Ai, Ai, Wwr, Wwr, Wwr, Ai, Ai, Ha, Ha, Ha^Fma, Ha
Aa, Aa, Re^Vct, Aa, Aa, Aa, Cea, Cea, Cea, Aa, Aa, Aa, Re^Vct, Aa, Aa, Aa, Aa, Ha, Ha, Ha, Aa, Ha, Ha, Ha^Fda, Ha, Ha^Fda, Ha, Ha, Ha, Ha, Ha, Ai, Ai, Wwr, Wwr, Ai, Ha, Ha^Fma, Ha, Ha, Ha, Ha
Aa, Aa, Aa, Aa, Aa, Aa, Cea, 1 Kea, Cea, Aa, Aa, Aa, Aa, Aa, Aa, Aa, Aa, Aa, Aa, Aa, Aa, Aa, Aa, Ha, Ha, Ha, Aa, Ha, Ha, Ha, Aa, Ai, Ai, Wwr, Ai, Ai, Aa, Ha, Ha, Ha^Fma, Ha, Ha
Aa, Aa, Re^Vct, Aa, Aa, Aa, Aa, Cea, Aa, Aa, Re^Vct, Aa, Aa, Aa, Aa, Aa, Aa, Aa, Aa, Aa, Aa, Aa, Aa, Aa, Aa, Aa, Aa, Aa, Aa, Aa, Ai, Ai, Wwr, Wwr, Ai, Ai, Aa, Aa, Aa, Ha, Ha^Fma, Ha
Aa, Aa, Aa, Aa, Aa, Re^Vct, Aa, Aa, Aa, Aa, Aa, Aa, Aa, Aa, Aa, Aa, Aa, Aa, Aa, Aa, Aa, Aa, Aa, Aa, Aa, Aa, Aa, Aa, Aa, Ai, Ai, Ai, Wwr, Ai, Ai, Ai, Aa, Aa, Aa, Aa, Aa, Ha
Aa, Aa, Aa, Aa, Aa, Aa, Aa, Re^Vct, Aa, Aa, Aa, Aa, Aa, Aa, Aa, Aa, Aa, Aa, Aa, Aa, Aa, Aa, Ha, Aa, Aa, Aa, Aa, Aa, Ai, Ai, Ai, Wwr, Ai, Ai, Aa, Aa, Aa, Aa, Aa, Aa, Aa, Aa
Aa, Aa, Aa, Aa, Aa, Aa, Aa, Aa, Aa, Aa, Aa, Aa, Aa, Aa, Aa, Aa, Aa, Aa, Aa, Aa, Ha, Ha, Ms, Ha, Ha, Aa, Aa, Aa, Ai, Ai, Ai, Wwr, Ai, Ai, Aa, Aa, Aa, Aa, Aa, Aa, Aa, Aa
Aa, Aa, Aa, Aa, Aa, Aa, Aa, Aa, Aa, Aa, Aa, Aa, Rr^Dr, Aa, Aa, Aa, Aa, Aa, Aa, Aa, Ha, Ms, Ms, Ms, Ha, Aa, Aa, Aa, Ai, Ai, Ai, Wwr, Ai, Ai, Ai, Aa, Aa, Aa, Aa, Aa, Aa, Aa
Aa, Aa, Aa, Aa, Aa, Aa, Aa, Aa, Aa, Aa, Aa, Aa, Coa, Aa, Aa, Aa, Aa, Aa, Aa, Aa, Ha, Ha, Ha, Ha, Aa, Aa, Aa, Aa, Ai, Ai, Wwr, Wwr, Wwr, Ai, Ai, Aa, Aa, Aa, Aa, Aa, Aa, Aa
Aa, Aa, Aa, Aa, Aa, Aa, Aa, Aa, Aa, Aa, Coa, Coa, Ce, Coa, Coa, Aa^Dr, Aa, Aa, Aa, Aa, Aa, Ha, Aa, Aa, Aa, Aa, Aa, Aa, Aa, Ai, Wwr, Wwr, Ai, Ai, Ai, Aa, Aa, Aa, Aa, Aa, Aa, Aa
Aa, Aa, Aa, Aa, Aa, Aa, Aa, Aa, Coa, Coa, Ce, Ce, Aa^Dr, Ce, Aa, Aa^Dr, Aa^Dr, Aa^Dr, Aa, Aa, Aa, Aa, Aa, Aa, Aa, Aa, Aa, Aa, Ai, Ai, Wwr, Ai, Ai, Ai, Aa, Aa, Aa, Aa, Aa, Aa, Aa, Aa
Aa, Aa, Aa, Aa, Aa, Aa, Coa, Aa^Dr, Ce, Ce, Ce, Ce, Ce, Ce, Aa, Aa, Ce, Coa, Coa, Aa, Aa, Aa, Aa, Aa, Aa, Aa, Ai, Ai, Ai, Wwr, Wwr, Ai, Ai, Aa, Aa, Aa, Aa, Aa, Aa, Aa, Aa, Aa
Aa, Aa, Rr^Dr, Aa, Coa, Coa^Dr, Ce, Aa, Aa^Vha, Aa^Dr, Ce, Ce, Ce^Dr, Aa, Aa, Aa^Dr, Aa^Dr, Ce, Ce, Coa, Coa, Aa, Rp^Vhcr, Aa, Ai, Ai, Ai, Ai, Wwr, Wwr, Ai, Ai, Ai, Aa, Aa, Aa, Aa, Aa, Aa, Aa, Aa, Aa
Aa, Aa, Aa, Aa^Dr, Ce, Ce, Ce, Aa, Ce, Ce^Dr, Ce, Ce, Ce, Aa, Aa, Ce, Ce, Ce, Ce, Ce, Ce, Coa, Ai, Ai, Ai, Wwr, Wwr, Wwr, Wwr, Wwr, Ai, Ai, Aa, Aa, Aa, Aa, Aa, Aa, Aa, Aa, Aa, Aa
Aa, Aa, Aa, Aa^Dr, Ce, Aa^Dr, Ce^Dr, Aa, Ce, Ce, Ce^Dr, Ce, Ce, Ce, Aa, Aa, Aa, Ce, Ce, Aa^Dr, Ce, Coa, Ai, Ai, Wwr, Wwr, Wwr, Wwr, Ai, Ai, Aa, Aa, Aa, Aa, Aa, Aa, Aa, Aa, Aa, Aa, Aa, Aa
Aa, Aa, Aa, Aa^Dr, Aa, Aa, Aa, Aa, Ce, Ce, Ce, Ce, Aa^Voa, Aa, Aa, Ce, Ce, Ce, Ce, Ce^Dr, Aa, Coa^Dr, Ai, Ai, Wwr, Wwr, Ai, Ai, Aa, Aa, Aa, Aa, Aa, Aa, Aa, Aa, Aa, Aa, Aa, Aa, Aa, Aa
Aa, Aa, Aa, Coa, Ce, Ce, Ce^Dr, Aa, Aa, Ce, Ce, Ce, Ce, Aa, Ce, Ce, Ce^Dr, Ce, Ce, Aa, Ce, Aa^Dr, Ai, Ai, Wwr, Wwr, Ai, Ai, Aa, Aa, Aa, Aa, Aa, Aa, Aa, Aa, Aa, Aa, Aa, Aa, Aa, Aa
Aa, Aa, Aa, Coa, Ce, Aa^Dr, Ce, Ce, Ce, Aa, Aa^Dr, Ce, Ha^Dr, Aa, Aa^Voa, Ce, Ce, Ce, Ce, Aa^Vha, Ce, Coa, Ai, Ai, Wwr, Wwr, Ai, Ai, Aa, Aa, Aa, Aa, Aa, Aa, Aa, Aa, Aa, Aa, Aa, Aa, Aa, Aa
Aa, Aa, Aa, Coa, Ce, Aa^Dr, Ce, Ce, Ce, Ce, Ce, Aa, Ce, Ce, Ce, Ce, Ce^Dr, Ce, Aa, Aa^Dr, Ce, Coa^Dr, Ai, Ai, Wwr, Wwr, Ai, Ai, Aa, Aa, Aa, Aa, Aa, Aa, Aa, Aa, Aa, Aa, Aa, Aa, Aa, Aa
Aa, Aa, Aa, Coa, Ce, Ce, Aa, Ce^Dr, Ce, Ce, Aa, Aa, Aa^Dr, Aa, Aa, Ce, Ce^Dr, Aa, Ce, Ce, Ce, Coa, Ai, Ai, Wwr, Wwr, Ai, Aa, Aa, Aa, Aa, Aa, Aa, Aa, Aa, Aa, Aa, Aa, Aa, Aa, Aa, Aa
Aa, Aa, Aa, Coa, Aa, Aa, Ce, Aa, Aa, Aa, Ce, Aa, Ce^Dr, Ce, Ce, Aa, Aa, Aa, Ce, Ce, Ce^Dr, Coa, Ai, Ai, Wwr, Wwr, Ai, Aa, Aa, Aa, Aa, Aa, Aa, Aa, Aa, Aa, Aa, Aa, Aa, Aa, Aa, Aa
Aa, Aa, Aa, Aa^Dr, Ce, Aa^Vea, Ce, Aa, Aa, Ce, Ce, Ce, Ce, Ce, Ce, Ce, Aa, Ce, Aa, Aa^Dr, Ce, Coa, Ai, Ai, Wwr, Ai, Ai, Aa, Aa, Aa, Aa, Aa, Aa, Aa, Aa, Aa, Aa, Aa, Aa, Aa, Aa, Aa
Aa, Aa, Rr^Dr, Coa, Coa^Dr, Ce, Aa, Aa, Aa^Dr, Ce, Ce, Ce, Ce^Dr, Ce, Aa, Aa, Aa^Vha, Aa, Ce, Aa, Aa^Dr, Coa, Rr^Dr, Ai, Wwr, Ai, Ai, Aa, Aa, Aa, Aa, Aa, Aa, Aa, Aa, Aa, Aa, Aa, Aa, Aa, Aa, Aa
Aa, Aa, Aa, Aa, Aa, Coa, Coa^Dr, Aa, Ce, Aa^Dr, Ce, Ce, Ce, Ce, Aa, Aa^Dr, Ce, Ce, Coa^Dr, Coa, Ai, Ai, Wwr, Wwr, Wwr, Ai, Ai, Aa, Aa, Aa, Aa, Aa, Re^Gvs, Aa, Aa, Aa, Aa, Aa, Aa, Aa, Aa^Fda, Aa^Fda
Aa, Aa, Aa, Aa, Aa, Aa, Aa, Aa^Dr, Coa, Ce, Ce, Ce^Dr, Aa^Dr, Aa, Aa, Ce, Coa, Coa, Ai, Ai, Wwr, Wwr, Wwr, Wwr, Ai, Ai, Aa, Aa, Aa, Aa, Re^Gvs, Re^Gvs, Re^Gvs, Re^Gvs, Re^Gvs, Aa, Aa, Aa, Aa^Fda, Aa^Fda, Aa^Fda, Aa^Fda
Aa, Aa, Aa, Aa, Aa, Aa, Aa, Aa, Aa, Coa, Coa, Ce, Aa, Aa, Coa^Dr, Coa, Ai, Ai, Wwr, Ai, Wwr, Wwr, Ai, Ai, Ai, Aa, Aa, Aa, Aa, Aa, Aa, Re^Gvs, Re^Gvs, Re^Gvs, Aa, Aa, Aa^Fpa, Cea, Cea, Aa^Fda, Cea, Aa^Fda
Aa, Aa, Aa, Aa, Aa, Aa, Aa, Aa, Aa, Aa, Aa, Aa^Dr, Coa, Coa, Ai, Ai, Wwr, Wwr, Wwr, Wwr, Ai, Ai, Ai, Ai, Aa, Aa, Aa, Aa, Aa, Aa, Aa, Aa, Aa, Aa, Aa^Fpa, Aa^Fda, Aa^Fpa, Aa^Fda, Cea, 3 Kea, Aa^Fda, Aa^Fda
Aa, Aa, Aa, Aa, Aa, Aa, Aa, Aa, Aa, Aa, Aa, Aa, Rp^Vhcr, Ai, Wwr, Wwr, Wwr, Wwr, Ai, Ai, Ai, Ai, Aa, Aa, Aa, Aa, Aa, Aa, Aa, Aa, Aa, Aa, Aa^Fda, Aa^Fda, Aa^Fpa, Aa^Fda, Aa^Fpa, Cea, Aa^Fda, Cea, Cea, Aa^Fda
Aa, Aa, Aa, Aa, Aa, Aa, Aa, Aa, Aa, Aa, Ai, Ai, Ai, Ai, Wwr, Wwr, Ai, Ai, Ai, Ai, Aa, Aa, Aa, Aa, Aa, Aa, Aa, Aa, Aa, Aa, Aa^Fpa, Aa^Fpa, Aa^Fpa, Aa^Fpa, Aa^Fpa, Aa^Fpa, Aa^Fpa, Aa^Fda, Aa^Fda, Aa^Fda, Aa^Fda, Aa^Fda
