Gs, Gs, Gs, Gs, Gs, Gs, Gs, Gs, Gs, Gs, Gs, Gs, Gs, Gs
Gs, Gs, Gs, Gs, Gs, Gs, Gs, Gs, Gs, Gs, Gs, Gs, Gs, Gs
Gs, Gs, Gs, Gs, Gs, Gs, Gs, Gs, Gs, Gs, Gs^Efm, Gs, Gs, Gs
Gs, Gs, Gs, Gs^Es, Gs, Gs, Gs, Gs, Gs, Gs, Gs, Gs, Gs, Gs
Gs, Gs, Gs, Gs, Gs, Gs, Gs^Efm, Gs, Gs^Es, Gs, Gs, Gs^Es, Gs, Gs
Gs, Gs, Gs^Es, Gs, Gs, Gs^Es, 1 Gs, Gs, Gs, Gs, Gs^Efm, Gs, Gs, Gs
Gs, Gs, Gs^Efm, Gs, Gs, Gs, Gs, 2 Gs, Gs, Gs, Gs, Gs, Gs, Gs
Gs, Gs, Gs, Gs, Gs, Gs, Gs^Efm, Gs, Gs, Gs, Gs, Gs^Es, Gs, Gs
Gs, Gs, Gs, Gs^Es, Gs, Gs, Gs, Gs^Es, Gs, Gs, Gs, Gs, Gs, Gs
Gs, Gs, Gs, Gs, Gs, Gs, Gs, Gs, Gs, Gs, Gs^Efm, Gs, Gs^Es, Gs
Gs, Gs, Gs, Gs^Es, Gs, Gs, Gs, Gs, Gs^Es, Gs, Gs, Gs, Gs, Gs
Gs, Gs, Gs, Gs, Gs, Gs, Gs, Gs, Gs, Gs, Gs, Gs, Gs, Gs
Gs, Gs, Gs, Gs, Gs, Gs, Gs, Gs, Gs, Gs, Gs, Gs, Gs, Gs
Gs, Gs, Gs, Gs, Gs, Gs, Gs, Gs, Gs, Gs, Gs, Gs, Gs, Gs
