Ss, Ss, Ss, Ss, Ss, Ss, Ss, Ss, Ss, Ss, Ss, Ss, Ss, Ss, Ss, Ss, Ss, Ss, Ss, Aa^Fma, Aa^Fma, Aa^Fma, Aa^Fma, Aa^Fma, Aa^Fpa, Aa^Fma, Aa^Fma, Aa^Fma, Aa^Fma, Aa^Fma, Aa^Fma, Aa^Fma, Aa^Fma, Aa^Fma, Aa^Fma, Aa^Fpa, Aa^Fpa, Aa^Fpa, Aa^Fpa, Aa^Fpa, Aa^Fpa, Aa^Fpa, Aa^Fpa, Aa^Fpa, Aa^Fpa, Aa^Fpa
Ss, Ss, Ss^Vhs, Ss, Ss, Ss, Ss, Ss, Ss, Ss, Ss, Ss, Ss, Ss, Ss, Ss, Ss, Ss^Vm, Ss, Aa^Fma, Aa^Fma, Aa^Fma, Aa^Fma, Aa^Fma, Aa^Fma, Aa^Fma, Aa^Fma, Aa^Vha, Aa^Fma, Aa^Fma, Aa^Fma, Aa^Fma, Aa^Fma, Aa^Fma, Aa^Fpa, Aa^Fpa, Aa^Fpa, Aa^Fpa, Aa^Fpa, Aa^Fpa, Aa^Fpa, Aa^Fpa, Aa^Fpa, Aa^Fpa, Aa^Fpa, Aa^Fpa
Ss, Ss, Ss, Ss, Ss, Ss, Ss, Ss^Vhs, Ss, Ss, Ss, Ss, Chs, Ss, Ss, Ss, Ss, Ss, Aa^Fpa, Aa^Fma, Aa^Fma, Aa^Fma, Aa^Fma, Aa^Fma, Aa^Fma, Aa^Fma, Aa^Fma, Aa^Fma, Aa^Fma, Aa^Fma, Aa^Fma, Aa^Fma, Aa^Fma, Aa^Fma, Ai, Ai, Aa^Fpa, Aa^Fpa, Coa, Coa, Coa, Aa^Fpa, Aa^Fpa, Aa^Fpa, Aa^Fpa, Aa^Fpa
Ss, Ss, Ss, Ss, Ss, Ss, Ss, Ss, Ss, Ss, Ss, Chs, 3 Kv, Chs, Ss, Ss, Aa^Fma, Aa^Fma, Aa^Fma, Aa^Fma, Aa^Fma, Aa^Fma, Aa^Fpa, Aa^Fma, Aa^Fma, Aa^Fma, Aa^Fpa, Gs^Fp, Gs^Fp, Aa^Fda, Aa^Fpa, Aa^Fpa, Aa^Fpa, Aa^Fma, Aa^Fpa, Ai, Aa^Fpa, Aa^Fpa, Coa, 4 Koa, Coa, Aa^Fpa, Aa^Fpa, Aa^Fpa, Aa^Fpa, Aa^Fpa
Ss, Ss, Ss, Ss^Vm, Ss, Ss, Ss, Ss, Ss, Ss, Rd, Chs, Chr, Chr, Rd, Ss, Aa^Fma, Aa^Fma, Aa^Fma, Aa^Fma, Aa^Fda, Aa^Fda, Aa^Fda, Aa^Fma, Aa^Fma, Aa^Fma, Gs^Fp, Gs^Fp, Aa^Fpa, Aa^Fma, Aa^Fma, Aa^Vha, Aa^Fma, Aa^Fma, Aa^Fpa, Aa^Fpa, Aa^Fpa, Aa^Fpa, Rd, Coa, Rd, Aa^Fpa, Aa^Fpa, Aa^Fpa, Aa^Fpa, Aa^Fpa
Ss, Ss, Ss, Ss, Ss, Ss, Ss^Vhs, Ss, Ss, Ss, Aa^Fma, Rd, Rd, Rd, Aa^Fma, Aa^Fma, Aa^Fma, Aa^Fda, Aa^Fda, Aa^Fda, Aa^Fda, Aa^Voa, Aa^Fda, Aa^Fda, Aa^Fda, Gs^Fp, Gs^Fp, Aa^Fma, Aa^Fpa, Aa^Fpa, Aa^Fda, Aa^Fma, Aa^Fma, Aa^Fma, Aa^Fma, Aa^Fpa, Aa^Fpa, Aa^Fpa, Rd, Rd, Aa, Aa^Fpa, Aa^Fpa, Aa^Fpa, Ai, Aa^Fpa
Ss, Ss, Ss, Ss, Ss, Ss, Ss, Ss, Aa^Fma, Aa^Fpa, Aa^Fpa, Rd, Aa, Aa, Aa^Fma, Aa^Fma, Aa^Fma, Aa^Fda, Gs^Fmw, Gs^Fmw, Gs^Fmw, Aa^Fda, Aa^Fda, Aa^Fda, Aa^Fda, Aa^Fma, Aa^Fpa, Aa^Fma, Aa^Fma, Aa^Fma, Aa^Fma, Aa^Fma, Aa^Fma, Aa^Fpa, Aa^Fma, Aa^Fpa, Aa^Fpa, Aa, Aa, Aa, Rd, Aa^Fpa, Aa^Fpa, Ai, Ai, Aa^Fpa
Ss, Ss, Aa^Vha, Ss, Aa^Fma, Ss, Aa^Fda, Aa^Fda, Aa^Fma, Aa^Fda, Aa^Fma, Aa, Rd, Rd, Aa^Fma, Aa^Fma, Gs^Fmw, Gs^Fmw, Gs^Fmw, Aa^Fda, Gs^Fmw, Aa^Fda, Aa^Fda, Aa^Fda, Aa^Fma, Aa^Fma, Aa^Fma, Aa^Fma, Aa^Fma, Aa^Fma, Aa^Vea, Aa^Fda, Aa^Fda, Aa^Fma, Aa^Fda, Aa^Fma, Aa^Fpa, Aa^Fpa, Rd, Aa, Rd, Aa^Fpa, Aa^Fpa, Aa^Fma, Aa^Fma, Aa^Fma
Aa^Fma, Aa^Fma, Aa^Fma, Aa^Fma, Aa^Fma, Aa^Fma, Aa^Fma, Aa^Fda, Gs^Fdf, Aa^Fma, Aa^Fda, Rd, Aa, Rd, Aa^Fma, Gs^Fmw, Aa^Fma, Aa^Vea, Gs^Fmw, Gs^Fmw, Aa^Fma, Aa^Fma, Aa^Fma, Aa^Fma, Aa^Fma, Aa^Fma, Aa^Fma, Aa^Fma, Aa^Fma, Aa^Fma, Aa^Fma, Aa^Fpa, Aa^Fma, Aa^Fma, Gs^Fdw, Gs^Fdw, Gs^Fdw, Aa^Fpa, Rd, Aa, Aa, Aa^Fpa, Aa^Fpa, Aa^Fma, Aa^Fma, Aa^Fma
Aa^Fma, Aa^Fma, Aa^Fma, Aa^Fma, Aa^Fma, Aa^Fma, Gs^Fdf, Gs^Fdf, Aa^Fpa, Gs^Fdf, Aa^Fda, Aa, Aa, Rd, Mm, Aa^Fma, Aa^Fpa, Aa^Fda, Gs^Fmw, Aa^Fma, Aa^Fma, Aa^Fma, Aa, Aa^Fma, Aa^Fma, Aa^Fma, Aa, Aa, Aa^Fma, Aa^Fma, Aa^Fma, Aa^Fma, Ai, Gs^Fdw, Aa^Fda, Aa^Fma, Aa^Fpa, Gs^Fdw, Aa, Aa, Aa, Aa^Fpa, Aa^Fpa, Aa^Fda, Aa^Fma, Aa^Fma
Aa, Aa^Fma, Aa, Aa^Fma, Gs^Fdf, Gs^Fdf, Aa^Fma, Gs^Fdf, Aa^Fma, Aa^Fma, Aa^Fma, Rd, Rd, Aa, Aa^Fma, Aa^Fma, Aa^Fma, Aa^Fma, Aa^Fma, Aa^Fma, Aa, Aa, Aa, Aa, Aa, Aa, Aa, Aa, Aa, Aa^Fma, Aa^Fma, Aa^Fma, Aa^Fma, Gs^Fdw, Aa^Fma, Aa^Feta, Aa^Fpa, Gs^Fdw, Rd, Aa, Rd, Aa^Fpa, Aa^Fpa, Aa^Fma, Aa^Vea, Aa^Fma
Aa, Aa, Aa, Aa^Fma, Aa^Fma, Gs^Fdf, Aa^Fma, Aa^Fma, Aa^Fma, Aa^Fma, Aa^Fma, Rd, Aa, Rd, Aa, Aa^Fma, Aa^Fma, Aa^Fma, Aa^Fma, Aa^Fma, Aa, Aa, Aa, Aa, Aa, Aa, Aa, Aa^Vha, Aa, Aa^Fma, Aa^Fma, Aa^Fma, Aa^Fma, Gs^Fdw, Gs^Fdw, Aa^Fma, Gs^Fdw, Gs^Fdw, Rd, Rd, Rd, Aa^Fpa, Aa^Fpa, Aa^Fma, Aa^Fma, Aa^Fma
Aa, Aa, Aa, Aa, Aa, Aa^Fma, Aa, Aa, Aa, Aa^Fma, Aa^Fma, Aa, Aa, Rd, Aa, Aa, Aa, Aa^Fma, Aa, Aa, Ai, Aa, Aa, Aa, Aa, Aa, Aa, Aa, Aa, Aa, Aa, Aa^Fma, Aa, Aa, Aa^Fma, Gs^Fdw, Aa^Fpa, Aa^Fpa, Rd, Aa, Rd, Aa^Fpa, Aa^Fpa, Aa^Fma, Aa^Fma, Aa^Fma
Aa, Aa, Aa, Aa, Aa, Aa^Vha, Aa, Aa, Aa, Aa, Aa, Rd, Rd, Rd, Aa, Aa, Aa, Aa, Aa, Ai, Ai, Ai, Aa, Aa, Aa, Aa, Aa, Aa, Aa, Aa, Aa, Aa, Ai, Aa, Aa, Aa^Fma, Aa^Fpa, Aa^Fpa, Rd, Aa, Rd, Aa^Fpa, Aa^Fpa, Aa^Fma, Aa^Fma, Aa^Fma
Aa, Aa, Aa, Aa, Aa, Aa, Aa, Aa, Aa, Aa, Aa, Rd, Rd, Aa, Aa, Aa, Aa, Aa, Aa, Ai, Ai, Ai, Aa, Aa^Voa, Aa, Aa, Aa, Ai, Aa, Aa, Aa, Aa, Aa, Ai, Aa, Aa^Voa, Aa, Aa^Fpa, Aa, Aa, Aa, Aa, Aa^Fpa, Aa^Fma, Aa^Fma, Aa^Fma
Aa, Aa, Re^Vct, Aa, Aa, Aa, Aa, Aa, Aa, Aa, Aa, Aa, Aa, Aa, Aa, Aa, Aa^Voa, Aa, Aa, Aa, Aa, Aa, Aa, Aa, Aa, Aa, Aa, Aa, Aa, Aa, Aa, Aa, Aa, Aa, Aa, Aa, Aa, Aa, Rd, Rd, Aa, Ai, Aa, Aa^Fma, Aa^Fma, Aa^Fma
Aa, Aa, Aa, Aa, Aa, Aa, Aa, Rr^Vd, Aa, Aa, Aa, Rd, Aa, Rd, Aa, Aa, Aa, Aa, Aa, Aa, Rr^Vd, Aa, Aa, Aa, Aa, Aa, Aa, Aa, Aa, Aa, Aa, Rr^Vd, Aa, Aa, Aa, Aa, Aa, Aa, Rd, Aa, Rd, Aa, Aa, Rr^Vd, Aa, Aa
Aa, Aa, Ce, Ce, Ce, Aa, Aa, Rp, Rp, Aa, Rp, Rp, Rp, Rp, Aa, Aa, Rp, Rp, Rp, Rp, Aa, Rp, Rp, Rp, Rp, Rp, Rp, Rp, Aa, Rp, Rp, Rp, Aa, Aa, Rp, Rp, Rp, Rp, Rp, Rp, Aa, Rp, Rp, Rp, Rp, Rp
Aa, Aa, 1 Ke, Ce, Ce, Ce, Aa, Rp, Rp, Rp, Rp, Rp, Aa, Rp, Aa, Rp, Rp, Rp, Rp, Rp, Rp, Aa, Rp, Rp, Rp, Rp, Rp, Aa, Rp, Rp, Rp, Rp, Aa, Aa, Rp, Rp, Rp, Rp, Rp, Aa, Rp, Rp, Rp, Rp, Rp, Rp
Aa, Aa, Aa, Ce, Ce, Ce, Aa, Rr^Vd, Aa, Aa, Aa, Aa, Aa, Aa, Ai, Aa, Aa, Aa, Aa, Aa, Rr^Vd, Aa, Aa, Aa, Aa, Aa, Aa, Aa, Aa, Aa, Aa, Rr^Vd, Aa, Aa, Aa, Aa, Aa, Aa, Aa, Aa, Aa, Aa, Aa, Rr^Vd, Aa, Aa
Aa, Re^Vct, Aa, Aa, Aa, Aa, Aa, Aa, Aa, Aa, Aa, Aa, Aa, Ai, Ai, Aa, Aa, Aa, Aa^Voa, Aa, Aa, Aa, Aa, Aa, Aa, Aa, Aa, Aa, Gs, Aa, Aa, Aa, Aa, Gs, Gs, Gs, Aa, Aa, Aa, Aa, Ha, Aa, Ha, Aa, Aa, Aa
Aa, Aa, Ce, Ce, Ce, Aa, Aa, Re^Vct, Aa, Aa, Aa, Aa, Aa, Aa, Aa, Aa, Aa, Aa, Aa, Aa, Gs, Aa, Aa, Aa, Aa, Aa, Gs, Gs, Gs, Aa, Ha, Aa, Aa, Gs, Ha, Aa, Ha, Ai, Ha, Ha, Ha, Ha, Ha, Ha, Ha, Aa
Aa, 2 Ke, Ce, Ce, Ce, Ce, Aa, Aa, Aa, Aa, Aa, Aa, Ha, Aa, Ha, Ha, Ha, Ha, Ha, Ha, Gs, Gs, Ha, Aa, Ha, Gs, Gs, Gs, Gg^Vo, Ha, Ha, Ha, Ha, Ha, Ha, Ha, Ha, Ha, Ha, Ha, Ha, Ha, Ha^Voa, Ha, Ha, Aa
Aa, Aa, Aa, Ce, Aa, Aa, Gs, Re^Vct, Aa, Aa, Ha, Ha, Ha, Ha, Ha^Voa, Ha, Ha, Ha, Ha^Fma, Ha, Ha, Ha, Ha, Ha, Ha, Ha, Ha, Ha, Ha, Ha, Ha, Ha, Ha, Ha, Ha, Ha, Hh, Ha, Hh, Ha, Ha, Ha, Ha, Ha, Gs, Gs
Aa, Re^Vct, Aa, Aa, Aa, Aa, Gs, Gs, Ha, Ha, Ha, Ha, Ha, Ha, Ha, Ha, Ha, Ha, Ha, Ha, Ha, Ha, Ha, Ha, Ha^Fma, Ha, Ha, Ha, Ha, Ha, Ha, Ha, Ha, Ha, Ha, Ha, Ha, Hh, Ha, Hh, Ha, Ha, Gs, Gs, Gs, Gs
Ha, Ha, Ha, Ha, Ha, Ha, Ha, Ha, Ha, Ha, Ha, Ha, Ha, Ha, Ha, Ha, Hh, Hh, Hh, Ha, Ha, Ha, Ha, Ha, Ha, Ha, Ha, Ha, Ha^Voa, Ha, Ha, Ha^Fda, Ha, Ha, Ha, Ha, Ha, Ha, Ha, Ha, Ha, Ha, Ha, Ha, Ha, Gs
Ha, Ha, Ha, Ha, Ha, Ha, Ha, Ha, Ha, Ha, Ha^Voa, Ha, Ha, Ha^Fda, Ha, Ha, Ha, Hh^Vo, Hh, Ha, Ha, Ha, Ha, Ha, Ha, Ha, Ha, Ha, Ha, Ha, Hh, Ha, Ha, Ha, Ha^Fma, Ha, Ha, Ha, Ha^Fda, Ha, Ha, Ha, Ha, Ha^Fma, Ha, Ha
Ha, Ha, Ha, Ha, Ha, Ha, Ha, Ha, Hh, Ha, Ha, Ha, Ai, Ha, Ha, Ha, Ha, Ha, Ha, Ha, Ha, Ha^Fda, Ha, Ha, Ha, Ha, Ha, Ha, Hh, Hh, Ha, Ha, Ha, Ha, Ha, Ha, Ha, Ha, Ha, Ha, Ha, Ha, Ha, Ha, Ha, Ha
Ha, Ha^Voa, Ha, Ha, Ha, Ha, Ha, Ha, Hh, Hh, Ha, Ha, Ai, Ai, Ha, Ha, Ha, Ha, Ha, Ha, Ha, Ha, Ha, Ha, Ha, Ha, Ha, Hh, Hh^Vo, Hh, Ha, Ha, Ha, Ha^Voa, Ha, Ha, Ha, Ha, Ha, Ha, Ha, Ha, Ha, Ha^Voa, Ha, Ha
Ha, Ha, Ha, Ha, Ha, Ha, Ha, Ha, Ha, Hh, Hh, Ha, Ha, Ha, Ha, Ha, Ha^Voa, Ha, Ha, Ha^Fma, Ha, Ha, Ha, Ha^Voa, Ha, Ha, Ha, Ha, Ha, Ha, Ha, Ha, Ha, Ha, Hh, Hh, Hh, Hh, Hh^Vo, Hh, Ms, Ms, Ms, Ha, Ha, Ha
Ha, Ha, Ha, Ha, Ha, Ha^Voa, Ha, Ha, Ha, Ha, Ha^Fda, Ha, Ha, Ha, Ha, Ha, Ha, Ha, Ha, Ha, Ha, Ha, Ha, Ha, Ha, Ha, Ai, Ai, Ai, Ha, Ha, Ha, Hh, Hh, Hh, Hh, Ms, Ms, Ms, Ms, Cea, Ms, Ms, Ms, Ms, Ha
Ms, Ms, Ms, Ha, Ms, Ha, Ha, Ha, Ha, Ha, Ha, Ha, Ha, Ha, Ha, Ha, Ha, Ha, Ha, Ha, Cea, Ms, Ms, Ms, Ms, Ms, Ms, Ai, Ai, Ha, Hh, Hh, Hh, Hh^Vo, Ms, Mm, Mm, Ms, Mm, Cea, 5 Kea, Cea, Ms, Ms, Ms, Ms
Ms, Ms, Ms, Ms, Ms, Ms, Ms, Ms, Ms, Ha, Ha, Ha, Ha, Ha, Ms, Ha, Ms, Ms, Ms, Cea, 6 Kea, Cea, Ms, Ms, Ms, Ms, Ms, Ms, Ms, Hh, Mm, Hh, Mm, Ms, Ms, Ms, Mm, Mm, Mm, Cea, Cea, Cea, Ms, Ms, Ms, Ms
Ms, Ms, Ms, Ms, Ms, Ms, Ms, Ms, Ms, Ms, Ms, Ms, Ms, Ms, Ms, Ms, Ms, Ms, Ms, Cea, Cea, Cea, Ms, Ms, Ms, Ms, Ms, Ms, Ms, Ms, Mm, Mm, Mm, Mm, Mm, Mm, Mm, Mm, Mm, Mm, Ms, Ms, Ms, Ms, Ms, Ms
Ms, Ms, Ms, Ms, Ms, Ms, Ms, Ms, Ms, Ms, Ms, Ms, Ms, Ms, Ms, Ms, Ms, Ms, Ms, Ms, Ms, Ms, Ms, Ms, Ms, Ms, Mm, Mm, Mm, Mm, Mm, Mm, Mm, Mm, Mm, Mm, Mm, Mm, Mm, Mm, Ms, Ms, Ms, Ms, Ms, Ms
